시군명,기준년월,신규가입자수,충전액,사용액,누적가입자수,인당충전액,인당사용액,전달 대비 충전액,전달 대비 사용액
가평군,2019-01,0,0,0,0,0,0,0,0
가평군,2019-02,0,0,0,0,0,0,0,0
가평군,2019-03,1,0,0,1,0,0,0,0
가평군,2019-04,87,8,2,88,90909,22727,8,2
가평군,2019-05,506,109,59,594,183501,99326,101,57
가평군,2019-06,238,84,75,832,100961,90144,-25,16
가평군,2019-07,389,207,113,1221,169533,92547,123,38
가평군,2019-08,272,100,138,1493,66979,92431,-107,25
가평군,2019-09,428,233,172,1921,121290,89536,133,34
가평군,2019-10,325,257,212,2246,114425,94390,24,40
가평군,2019-11,179,139,188,2425,57319,77525,-118,-24
가평군,2019-12,289,247,201,2714,91009,74060,108,13
가평군,2020-01,338,288,247,3052,94364,80930,41,46
가평군,2020-02,211,180,230,3263,55163,70487,-108,-17
가평군,2020-03,655,389,297,3918,99285,75803,209,67
가평군,2020-04,6835,639,477,10753,59425,44359,250,180
가평군,2020-05,3425,713,642,14178,50289,45281,74,165
가평군,2020-06,398,616,518,14576,42261,35537,-97,-124
가평군,2020-07,533,676,732,15109,44741,48447,60,214
가평군,2020-08,312,597,661,15421,38713,42863,-79,-71
가평군,2020-09,862,1052,964,16283,64607,59202,455,303
가평군,2020-10,550,921,952,16833,54713,56555,-131,-12
가평군,2020-11,524,1014,991,17357,58420,57095,93,39
가평군,2020-12,579,1177,1121,17936,65622,62500,163,130
가평군,2021-01,598,992,1011,18534,53523,54548,-185,-110
가평군,2021-02,1809,912,805,20343,44831,39571,-80,-206
가평군,2021-03,1084,912,805,21427,42563,37569,0,0
가평군,2021-04,991,1436,1305,22418,64055,58212,524,500
가평군,2021-05,614,1402,1365,23032,60871,59265,-34,60
가평군,2021-06,1667,1822,1754,24699,73768,71015,420,389
가평군,2021-07,735,1588,1664,25434,62436,65424,-234,-90
가평군,2021-08,618,1588,1664,26052,60955,63872,0,0
가평군,2021-09,1510,1588,1664,27562,57615,60372,0,0
가평군,2021-10,1399,1246,1228,28961,43023,42401,-342,-436
가평군,2021-11,1298,2028,1738,30259,67021,57437,782,510
가평군,2021-12,720,2217,2080,30979,71564,67142,189,342
가평군,2022-01,508,2231,2236,31487,70854,71013,14,156
가평군,2022-02,427,2063,1920,31914,64642,60161,-168,-316
가평군,2022-03,481,2393,2418,32395,73869,74641,330,498
가평군,2022-04,641,2585,2600,33036,78247,78702,192,182
가평군,2022-05,627,2784,2810,33663,82702,83474,199,210
가평군,2022-06,572,2771,2681,34235,80940,78311,-13,-129
가평군,2022-07,1173,3600,3996,35408,101671,112855,829,1315
가평군,2022-08,858,3091,3600,36266,85231,99266,-509,-396
가평군,2022-09,832,4334,3773,37098,116825,101703,1243,173
가평군,2022-10,657,3205,3586,37755,84889,94980,-1129,-187
가평군,2022-11,701,4356,3673,38456,113272,95511,1151,87
가평군,2022-12,814,3600,3996,39270,91673,101757,-756,323
가평군,2023-01,717,3140,3540,39987,78525,88528,-460,-456
가평군,2023-02,769,3032,3092,40756,74393,75866,-108,-448
가평군,2023-03,3130,4284,3609,43886,97616,82235,1252,517
가평군,2023-04,855,3668,4057,44741,81982,90677,-616,448
가평군,2023-05,871,5064,3785,45612,111023,82982,1396,-272
가평군,2023-06,883,4197,4043,46495,90267,86955,-867,258
가평군,2023-07,580,2682,2536,47075,56972,53871,-1515,-1507
가평군,2023-08,473,3631,2392,47548,76364,50307,949,-144
가평군,2023-09,782,3113,2376,48330,64411,49162,-518,-16
가평군,2023-10,555,2596,2335,48885,53104,47765,-517,-41
가평군,2023-11,458,2368,2187,49343,47990,44322,-228,-148
가평군,2023-12,484,4051,2140,49827,81301,42948,1683,-47
고양시,2019-01,0,0,0,0,0,0,0,0
고양시,2019-02,0,0,0,0,0,0,0,0
고양시,2019-03,0,0,0,0,0,0,0,0
고양시,2019-04,76,9,1,76,118421,13157,9,1
고양시,2019-05,13077,3133,1021,13153,238196,77624,3124,1020
고양시,2019-06,4368,1094,1478,17521,62439,84355,-2039,457
고양시,2019-07,11964,6565,2688,29485,222655,91164,5471,1210
고양시,2019-08,8535,6035,4859,38020,158732,127801,-530,2171
고양시,2019-09,5421,6220,4437,43441,143182,102138,185,-422
고양시,2019-10,5024,4542,4017,48465,93717,82884,-1678,-420
고양시,2019-11,3448,2397,4583,51913,46173,88282,-2145,566
고양시,2019-12,6994,9138,5652,58907,155125,95947,6741,1069
고양시,2020-01,6758,9669,6403,65665,147247,97510,531,751
고양시,2020-02,5041,6134,5866,70706,86753,82963,-3535,-537
고양시,2020-03,10166,8183,6663,80872,101184,82389,2049,797
고양시,2020-04,113877,10835,8742,194749,55635,44888,2652,2079
고양시,2020-05,60602,24391,14063,255351,95519,55073,13556,5321
고양시,2020-06,7044,7521,13476,262395,28662,51357,-16870,-587
고양시,2020-07,16520,10801,14345,278915,38725,51431,3280,869
고양시,2020-08,7545,22718,16103,286460,79306,56213,11917,1758
고양시,2020-09,20944,25220,21980,307404,82041,71501,2502,5877
고양시,2020-10,10941,18871,22812,318345,59278,71658,-6349,832
고양시,2020-11,10341,21892,21763,328686,66604,66212,3021,-1049
고양시,2020-12,7511,8159,13731,336197,24268,40842,-13733,-8032
고양시,2021-01,15728,15152,15299,351925,43054,43472,6993,1568
고양시,2021-02,24208,17652,13760,376133,46930,36582,2500,-1539
고양시,2021-03,18749,17652,13760,394882,44701,34845,0,0
고양시,2021-04,15857,24135,21475,410739,58759,52283,6483,7715
고양시,2021-05,10276,23026,23133,421015,54691,54945,-1109,1658
고양시,2021-06,42692,32240,30107,463707,69526,64926,9214,6974
고양시,2021-07,9414,12641,19930,473121,26718,42124,-19599,-10177
고양시,2021-08,8878,12641,19930,481999,26226,41348,0,0
고양시,2021-09,12099,12641,19930,494098,25583,40336,0,0
고양시,2021-10,15312,8916,9264,509410,17502,18185,-3725,-10666
고양시,2021-11,19372,27417,18367,528782,51849,34734,18501,9103
고양시,2021-12,9234,22992,22803,538016,42734,42383,-4425,4436
고양시,2022-01,6621,22668,23750,544637,41620,43607,-324,947
고양시,2022-02,6016,21257,20602,550653,38603,37413,-1411,-3148
고양시,2022-03,4939,24939,24047,555592,44887,43281,3682,3445
고양시,2022-04,6159,26050,24929,561751,46372,44377,1111,882
고양시,2022-05,5984,23866,25809,567735,42037,45459,-2184,880
고양시,2022-06,6203,32092,24757,573938,55915,43135,8226,-1052
고양시,2022-07,9200,15077,13792,583138,25854,23651,-17015,-10965
고양시,2022-08,7144,12613,18201,590282,21367,30834,-2464,4409
고양시,2022-09,5300,13585,15383,595582,22809,25828,972,-2818
고양시,2022-10,5134,14457,14619,600716,24066,24335,872,-764
고양시,2022-11,3563,12957,13942,604279,21442,23072,-1500,-677
고양시,2022-12,3916,15077,13792,608195,24789,22676,2120,-150
고양시,2023-01,4126,1610,6951,612321,2629,11351,-13467,-6841
고양시,2023-02,4467,11680,9746,616788,18936,15801,10070,2795
고양시,2023-03,4029,13370,11819,620817,21536,19037,1690,2073
고양시,2023-04,4329,13576,12364,625146,21716,19777,206,545
고양시,2023-05,3722,11006,12514,628868,17501,19899,-2570,150
고양시,2023-06,2809,10175,11714,631677,16107,18544,-831,-800
고양시,2023-07,3811,14686,11992,635488,23109,18870,4511,278
고양시,2023-08,3527,11057,11989,639015,17303,18761,-3629,-3
고양시,2023-09,4207,10500,11022,643222,16324,17135,-557,-967
고양시,2023-10,4554,13499,11696,647776,20838,18055,2999,674
고양시,2023-11,3247,14389,12450,651023,22102,19123,890,754
고양시,2023-12,3103,15768,12994,654126,24105,19864,1379,544
과천시,2019-01,0,0,0,0,0,0,0,0
과천시,2019-02,0,0,0,0,0,0,0,0
과천시,2019-03,0,0,0,0,0,0,0,0
과천시,2019-04,99,25,1,99,252525,10101,25,1
과천시,2019-05,2356,738,164,2455,300610,66802,713,163
과천시,2019-06,600,163,291,3055,53355,95253,-575,127
과천시,2019-07,580,361,346,3635,99312,95185,198,55
과천시,2019-08,444,242,349,4079,59328,85560,-119,3
과천시,2019-09,1171,866,468,5250,164952,89142,624,119
과천시,2019-10,961,786,616,6211,126549,99178,-80,148
과천시,2019-11,297,304,535,6508,46711,82206,-482,-81
과천시,2019-12,436,492,548,6944,70852,78917,188,13
과천시,2020-01,935,1107,702,7879,140500,89097,615,154
과천시,2020-02,366,381,594,8245,46209,72043,-726,-108
과천시,2020-03,1004,1147,720,9249,124013,77846,766,126
과천시,2020-04,8257,1617,940,17506,92368,53695,470,220
과천시,2020-05,2143,1390,1051,19649,70741,53488,-227,111
과천시,2020-06,701,1676,1353,20350,82358,66486,286,302
과천시,2020-07,1263,2173,1917,21613,100541,88696,497,564
과천시,2020-08,852,1696,1973,22465,75495,87825,-477,56
과천시,2020-09,1884,2231,2373,24349,91625,97457,535,400
과천시,2020-10,994,2224,2286,25343,87755,90202,-7,-87
과천시,2020-11,981,2409,2287,26324,91513,86878,185,1
과천시,2020-12,781,1651,2075,27105,60911,76554,-758,-212
과천시,2021-01,1556,2509,2307,28661,87540,80492,858,232
과천시,2021-02,1975,2315,1923,30636,75564,62769,-194,-384
과천시,2021-03,1997,2315,1923,32633,70940,58928,0,0
과천시,2021-04,1848,3272,3050,34481,94892,88454,957,1127
과천시,2021-05,1207,3351,3316,35688,93897,92916,79,266
과천시,2021-06,3546,4523,3895,39234,115282,99276,1172,579
과천시,2021-07,1263,3477,3762,40497,85858,92895,-1046,-133
과천시,2021-08,1342,3477,3762,41839,83104,89916,0,0
과천시,2021-09,1277,3477,3762,43116,80642,87252,0,0
과천시,2021-10,1846,1773,1705,44962,39433,37920,-1704,-2057
과천시,2021-11,1772,3111,2586,46734,66568,55334,1338,881
과천시,2021-12,1268,2503,2993,48002,52143,62351,-608,407
과천시,2022-01,1150,3833,2966,49152,77982,60343,1330,-27
과천시,2022-02,1195,2316,2680,50347,46000,53230,-1517,-286
과천시,2022-03,1030,2665,2957,51377,51871,57554,349,277
과천시,2022-04,1083,4452,3387,52460,84864,64563,1787,430
과천시,2022-05,1088,4187,4095,53548,78191,76473,-265,708
과천시,2022-06,975,2946,3409,54523,54032,62524,-1241,-686
과천시,2022-07,1592,3619,3622,56115,64492,64546,673,213
과천시,2022-08,11130,9959,6458,67245,148100,96036,6340,2836
과천시,2022-09,3270,5848,6889,70515,82932,97695,-4111,431
과천시,2022-10,1586,3384,5104,72101,46934,70789,-2464,-1785
과천시,2022-11,784,3260,3711,72885,44727,50915,-124,-1393
과천시,2022-12,724,3619,3622,73609,49165,49205,359,-89
과천시,2023-01,982,5704,4197,74591,76470,56266,2085,575
과천시,2023-02,819,2626,3594,75410,34822,47659,-3078,-603
과천시,2023-03,688,2933,3561,76098,38542,46794,307,-33
과천시,2023-04,608,2935,3181,76706,38262,41470,2,-380
과천시,2023-05,506,2940,3146,77212,38076,40744,5,-35
과천시,2023-06,520,2746,2940,77732,35326,37822,-194,-206
과천시,2023-07,658,2897,2832,78390,36956,36127,151,-108
과천시,2023-08,798,2638,2771,79188,33313,34992,-259,-61
과천시,2023-09,1123,5776,3535,80311,71920,44016,3138,764
과천시,2023-10,740,3604,3738,81051,44465,46119,-2172,203
과천시,2023-11,602,3332,3538,81653,40806,43329,-272,-200
과천시,2023-12,535,3660,3712,82188,44532,45164,328,174
광명시,2019-01,0,0,0,0,0,0,0,0
광명시,2019-02,0,0,0,0,0,0,0,0
광명시,2019-03,9,0,0,9,0,0,0,0
광명시,2019-04,1477,502,66,1486,337819,44414,502,66
광명시,2019-05,3830,1010,531,5316,189992,99887,508,465
광명시,2019-06,1246,354,544,6562,53946,82901,-656,13
광명시,2019-07,2997,1693,884,9559,177110,92478,1339,340
광명시,2019-08,1256,628,960,10815,58067,88765,-1065,76
광명시,2019-09,1038,497,701,11853,41930,59141,-131,-259
광명시,2019-10,1742,1349,862,13595,99227,63405,852,161
광명시,2019-11,651,524,889,14246,36782,62403,-825,27
광명시,2019-12,1328,1307,931,15574,83921,59779,783,42
광명시,2020-01,1842,1460,1201,17416,83830,68959,153,270
광명시,2020-02,2064,1712,1132,19480,87885,58110,252,-69
광명시,2020-03,6608,1816,1364,26088,69610,52284,104,232
광명시,2020-04,21799,3323,2231,47887,69392,46588,1507,867
광명시,2020-05,22779,4820,3501,70666,68208,49542,1497,1270
광명시,2020-06,3506,5191,3993,74172,69985,53834,371,492
광명시,2020-07,6761,7448,5553,80933,92026,68612,2257,1560
광명시,2020-08,2240,4151,5334,83173,49908,64131,-3297,-219
광명시,2020-09,6892,7013,6851,90065,77865,76067,2862,1517
광명시,2020-10,3603,6729,7218,93668,71838,77059,-284,367
광명시,2020-11,3119,7880,7245,96787,81415,74855,1151,27
광명시,2020-12,3307,8118,6991,100094,81103,69844,238,-254
광명시,2021-01,5291,6346,6811,105385,60217,64629,-1772,-180
광명시,2021-02,8338,6043,5358,113723,53137,47114,-303,-1453
광명시,2021-03,5094,6043,5358,118817,50859,45094,0,0
광명시,2021-04,4610,9392,8719,123427,76093,70640,3349,3361
광명시,2021-05,2637,9377,9567,126064,74382,75890,-15,848
광명시,2021-06,10832,14788,11750,136896,108023,85831,5411,2183
광명시,2021-07,5160,7590,10095,142056,53429,71063,-7198,-1655
광명시,2021-08,5185,7590,10095,147241,51548,68561,0,0
광명시,2021-09,6851,7590,10095,154092,49256,65512,0,0
광명시,2021-10,4927,5945,5992,159019,37385,37681,-1645,-4103
광명시,2021-11,4285,10941,8530,163304,66997,52233,4996,2538
광명시,2021-12,3085,10956,9944,166389,65845,59763,15,1414
광명시,2022-01,2244,9849,11135,168633,58404,66030,-1107,1191
광명시,2022-02,2100,7489,8772,170733,43863,51378,-2360,-2363
광명시,2022-03,2028,9433,9945,172761,54601,57565,1944,1173
광명시,2022-04,2433,10618,10423,175194,60607,59494,1185,478
광명시,2022-05,2055,9589,10744,177249,54099,60615,-1029,321
광명시,2022-06,2105,15864,11716,179354,88450,65323,6275,972
광명시,2022-07,3134,11189,10721,182488,61313,58749,-4675,-995
광명시,2022-08,2745,9423,12093,185233,50871,65285,-1766,1372
광명시,2022-09,2380,10679,11523,187613,56920,61418,1256,-570
광명시,2022-10,2100,10448,10794,189713,55072,56896,-231,-729
광명시,2022-11,1775,9624,10293,191488,50259,53752,-824,-501
광명시,2022-12,2321,11189,10721,193809,57732,55317,1565,428
광명시,2023-01,2668,17080,12541,196477,86931,63829,5891,1820
광명시,2023-02,2690,9573,11621,199167,48065,58348,-7507,-920
광명시,2023-03,12936,18333,13846,212103,86434,65279,8760,2225
광명시,2023-04,20221,15752,17141,232324,67801,73780,-2581,3295
광명시,2023-05,7015,18861,17427,239339,78804,72813,3109,286
광명시,2023-06,3154,10419,14039,242493,42966,57894,-8442,-3388
광명시,2023-07,2718,9721,11928,245211,39643,48643,-698,-2111
광명시,2023-08,2427,8529,10113,247638,34441,40837,-1192,-1815
광명시,2023-09,2486,16970,12756,250124,67846,50998,8441,2643
광명시,2023-10,2235,8983,11292,252359,35596,44745,-7987,-1464
광명시,2023-11,1915,9298,9898,254274,36566,38926,315,-1394
광명시,2023-12,1474,2100,5453,255748,8211,21321,-7198,-4445
광주시,2019-01,0,0,0,0,0,0,0,0
광주시,2019-02,0,0,0,0,0,0,0,0
광주시,2019-03,0,0,0,0,0,0,0,0
광주시,2019-04,740,79,13,740,106756,17567,79,13
광주시,2019-05,4128,1140,486,4868,234182,99835,1061,473
광주시,2019-06,1336,388,455,6204,62540,73339,-752,-31
광주시,2019-07,1977,1067,619,8181,130424,75663,679,164
광주시,2019-08,1157,378,656,9338,40479,70250,-689,37
광주시,2019-09,1279,720,611,10617,67815,57549,342,-45
광주시,2019-10,2772,1897,1232,13389,141683,92015,1177,621
광주시,2019-11,1998,1568,1640,15387,101904,106583,-329,408
광주시,2019-12,2265,2185,1840,17652,123782,104237,617,200
광주시,2020-01,2095,2554,2128,19747,129336,107763,369,288
광주시,2020-02,1812,1412,1904,21559,65494,88315,-1142,-224
광주시,2020-03,4528,3417,2522,26087,130984,96676,2005,618
광주시,2020-04,30144,4030,3044,56231,71668,54133,613,522
광주시,2020-05,51184,5864,4777,107415,54592,44472,1834,1733
광주시,2020-06,10557,6643,5646,117972,56309,47858,779,869
광주시,2020-07,5980,8568,7997,123952,69123,64516,1925,2351
광주시,2020-08,2537,6723,7705,126489,53150,60914,-1845,-292
광주시,2020-09,5885,10053,9593,132374,75943,72468,3330,1888
광주시,2020-10,3368,9149,9420,135742,67399,69396,-904,-173
광주시,2020-11,3203,10205,9821,138945,73446,70682,1056,401
광주시,2020-12,3635,11846,10765,142580,83083,75501,1641,944
광주시,2021-01,5028,9606,10282,147608,65077,69657,-2240,-483
광주시,2021-02,9412,9002,7854,157020,57330,50019,-604,-2428
광주시,2021-03,6676,9002,7854,163696,54992,47979,0,0
광주시,2021-04,9060,13321,12608,172756,77108,72981,4319,4754
광주시,2021-05,65234,13952,12094,237990,58624,50817,631,-514
광주시,2021-06,27786,25219,19994,265776,94888,75228,11267,7900
광주시,2021-07,9674,12575,16722,275450,45652,60707,-12644,-3272
광주시,2021-08,3659,12575,16722,279109,45054,59912,0,0
광주시,2021-09,8441,12575,16722,287550,43731,58153,0,0
광주시,2021-10,5771,11401,11243,293321,38868,38330,-1174,-5479
광주시,2021-11,4704,21660,17102,298025,72678,57384,10259,5859
광주시,2021-12,3307,23803,20506,301332,78992,68051,2143,3404
광주시,2022-01,2309,18686,21125,303641,61539,69572,-5117,619
광주시,2022-02,2034,17494,17690,305675,57230,57871,-1192,-3435
광주시,2022-03,2114,21077,21462,307789,68478,69729,3583,3772
광주시,2022-04,2354,21940,22383,310143,70741,72169,863,921
광주시,2022-05,2504,23641,23687,312647,75615,75762,1701,1304
광주시,2022-06,2556,24828,23414,315203,78768,74282,1187,-273
광주시,2022-07,3678,30221,23521,318881,94772,73761,5393,107
광주시,2022-08,3071,30757,24776,321952,95532,76955,536,1255
광주시,2022-09,2198,16409,22534,324150,50621,69517,-14348,-2242
광주시,2022-10,1892,18930,20639,326042,58060,63301,2521,-1895
광주시,2022-11,1652,16804,19261,327694,51279,58777,-2126,-1378
광주시,2022-12,2454,30221,23521,330148,91537,71243,13417,4260
광주시,2023-01,2638,26982,23709,332786,81079,71243,-3239,188
광주시,2023-02,2503,12312,17690,335289,36720,52760,-14670,-6019
광주시,2023-03,2103,16317,18922,337392,48362,56083,4005,1232
광주시,2023-04,1991,16112,17603,339383,47474,51867,-205,-1319
광주시,2023-05,1708,17582,16384,341091,51546,48034,1470,-1219
광주시,2023-06,1235,9267,6642,342326,27070,19402,-8315,-9742
광주시,2023-07,1852,15317,14254,344178,44503,41414,6050,7612
광주시,2023-08,1862,15239,14372,346040,44038,41532,-78,118
광주시,2023-09,1613,11394,8828,347653,32774,25393,-3845,-5544
광주시,2023-10,1698,12414,10128,349351,35534,28990,1020,1300
광주시,2023-11,1477,17709,17731,350828,50477,50540,5295,7603
광주시,2023-12,1375,12936,10317,352203,36728,29292,-4773,-7414
구리시,2019-01,0,0,0,0,0,0,0,0
구리시,2019-02,0,0,0,0,0,0,0,0
구리시,2019-03,0,0,0,0,0,0,0,0
구리시,2019-04,0,0,0,0,0,0,0,0
구리시,2019-05,2625,693,116,2625,264000,44190,693,116
구리시,2019-06,1359,509,387,3984,127761,97138,-184,271
구리시,2019-07,1527,801,523,5511,145345,94901,292,136
구리시,2019-08,610,195,516,6121,31857,84299,-606,-7
구리시,2019-09,1084,591,429,7205,82026,59541,396,-87
구리시,2019-10,1462,1106,679,8667,127610,78343,515,250
구리시,2019-11,505,263,611,9172,28674,66615,-843,-68
구리시,2019-12,1182,1206,745,10354,116476,71952,943,134
구리시,2020-01,1289,958,831,11643,82281,71373,-248,86
구리시,2020-02,884,779,701,12527,62185,55959,-179,-130
구리시,2020-03,3604,1573,967,16131,97514,59946,794,266
구리시,2020-04,30323,2039,1362,46454,43892,29319,466,395
구리시,2020-05,23609,2985,2494,70063,42604,35596,946,1132
구리시,2020-06,10273,4262,2391,80336,53052,29762,1277,-103
구리시,2020-07,5879,4307,3925,86215,49956,45525,45,1534
구리시,2020-08,2256,3169,3885,88471,35819,43912,-1138,-40
구리시,2020-09,3060,4636,4728,91531,50649,51654,1467,843
구리시,2020-10,1806,4340,4873,93337,46498,52208,-296,145
구리시,2020-11,1650,4824,4743,94987,50785,49933,484,-130
구리시,2020-12,2099,5865,4754,97086,60410,48966,1041,11
구리시,2021-01,2715,4255,4877,99801,42634,48867,-1610,123
구리시,2021-02,5096,4062,3846,104897,38723,36664,-193,-1031
구리시,2021-03,3352,4062,3846,108249,37524,35529,0,0
구리시,2021-04,2725,6309,5790,110974,56851,52174,2247,1944
구리시,2021-05,1620,6075,6135,112594,53954,54487,-234,345
구리시,2021-06,4460,7591,7058,117054,64850,60296,1516,923
구리시,2021-07,2145,6097,6556,119199,51149,55000,-1494,-502
구리시,2021-08,2007,6097,6556,121206,50302,54089,0,0
구리시,2021-09,4611,6097,6556,125817,48459,52107,0,0
구리시,2021-10,3375,4517,4627,129192,34963,35814,-1580,-1929
구리시,2021-11,3259,5901,5585,132451,44552,42166,1384,958
구리시,2021-12,2040,6068,6314,134491,45118,46947,167,729
구리시,2022-01,1687,6643,6765,136178,48781,49677,575,451
구리시,2022-02,1482,5999,5913,137660,43578,42953,-644,-852
구리시,2022-03,1320,7202,7009,138980,51820,50431,1203,1096
구리시,2022-04,6943,13383,8548,145923,91712,58578,6181,1539
구리시,2022-05,18969,11306,13181,164892,68566,79937,-2077,4633
구리시,2022-06,3378,7967,9326,168270,47346,55422,-3339,-3855
구리시,2022-07,2307,10746,9173,170577,62997,53776,2779,-153
구리시,2022-08,2152,8844,9520,172729,51201,55115,-1902,347
구리시,2022-09,1760,8997,9197,174489,51561,52708,153,-323
구리시,2022-10,1442,11050,9052,175931,62808,51451,2053,-145
구리시,2022-11,1287,7349,7993,177218,41468,45102,-3701,-1059
구리시,2022-12,1337,10746,9173,178555,60183,51373,3397,1180
구리시,2023-01,1696,11045,9239,180251,61275,51256,299,66
구리시,2023-02,2696,4726,5914,182947,25832,32326,-6319,-3325
구리시,2023-03,1904,6468,7903,184851,34990,42753,1742,1989
구리시,2023-04,1666,6415,7266,186517,34393,38956,-53,-637
구리시,2023-05,1962,15132,9300,188479,80284,49342,8717,2034
구리시,2023-06,1392,4649,7367,189871,24485,38800,-10483,-1933
구리시,2023-07,1327,6336,7712,191198,33138,40335,1687,345
구리시,2023-08,1479,5675,6597,192677,29453,34238,-661,-1115
구리시,2023-09,1754,14831,8557,194431,76278,44010,9156,1960
구리시,2023-10,1679,10079,9019,196110,51394,45989,-4752,462
구리시,2023-11,1257,4394,7730,197367,22263,39165,-5685,-1289
구리시,2023-12,1240,5998,7811,198607,30200,39328,1604,81
군포시,2019-01,0,0,0,0,0,0,0,0
군포시,2019-02,0,0,0,0,0,0,0,0
군포시,2019-03,0,0,0,0,0,0,0,0
군포시,2019-04,1866,736,160,1866,394426,85744,736,160
군포시,2019-05,6147,2341,1061,8013,292150,132409,1605,901
군포시,2019-06,3427,2379,1688,11440,207954,147552,38,627
군포시,2019-07,2219,1980,2154,13659,144959,157698,-399,466
군포시,2019-08,1434,1112,1874,15093,73676,124163,-868,-280
군포시,2019-09,2810,3840,2233,17903,214489,124727,2728,359
군포시,2019-10,1785,1987,2435,19688,100924,123679,-1853,202
군포시,2019-11,843,1442,2201,20531,70235,107203,-545,-234
군포시,2019-12,2003,3962,2832,22534,175823,125676,2520,631
군포시,2020-01,3076,4112,3165,25610,160562,123584,150,333
군포시,2020-02,1687,1510,2493,27297,55317,91328,-2602,-672
군포시,2020-03,6334,4263,3047,33631,126758,90600,2753,554
군포시,2020-04,42637,5374,4204,76268,70462,55121,1111,1157
군포시,2020-05,16685,6310,4959,92953,67883,53349,936,755
군포시,2020-06,2381,7907,5552,95334,82939,58237,1597,593
군포시,2020-07,4917,5737,7091,100251,57226,70732,-2170,1539
군포시,2020-08,2047,5704,6600,102298,55758,64517,-33,-491
군포시,2020-09,5625,9592,8789,107923,88878,81437,3888,2189
군포시,2020-10,3214,8822,9194,111137,79379,82726,-770,405
군포시,2020-11,3067,9813,9495,114204,85925,83140,991,301
군포시,2020-12,3564,11206,9576,117768,95153,81312,1393,81
군포시,2021-01,4452,8951,9831,122220,73236,80436,-2255,255
군포시,2021-02,8321,8468,7689,130541,64868,58901,-483,-2142
군포시,2021-03,4756,8468,7689,135297,62588,56830,0,0
군포시,2021-04,5638,11202,11390,140935,79483,80817,2734,3701
군포시,2021-05,2908,11440,11773,143843,79531,81846,238,383
군포시,2021-06,9774,15362,14155,153617,100001,92144,3922,2382
군포시,2021-07,3707,13735,13610,157324,87303,86509,-1627,-545
군포시,2021-08,3642,13735,13610,160966,85328,84552,0,0
군포시,2021-09,6731,13735,13610,167697,81903,81158,0,0
군포시,2021-10,6039,10083,9853,173736,58036,56712,-3652,-3757
군포시,2021-11,4618,16670,13701,178354,93465,76819,6587,3848
군포시,2021-12,3235,16423,15879,181589,90440,87444,-247,2178
군포시,2022-01,2521,13582,15881,184110,73771,86258,-2841,2
군포시,2022-02,2276,12767,13159,186386,68497,70600,-815,-2722
군포시,2022-03,2158,15224,15406,188544,80745,81710,2457,2247
군포시,2022-04,2434,16160,16189,190978,84617,84768,936,783
군포시,2022-05,2297,15994,16802,193275,82752,86933,-166,613
군포시,2022-06,2578,17918,16111,195853,91486,82260,1924,-691
군포시,2022-07,3972,14411,14258,199825,72118,71352,-3507,-1853
군포시,2022-08,3322,13662,15671,203147,67251,77141,-749,1413
군포시,2022-09,2566,14032,14605,205713,68211,70996,370,-1066
군포시,2022-10,2367,14020,14187,208080,67377,68180,-12,-418
군포시,2022-11,1926,13540,13626,210006,64474,64883,-480,-561
군포시,2022-12,2257,14411,14258,212263,67892,67171,871,632
군포시,2023-01,2826,17910,15187,215089,83267,70607,3499,929
군포시,2023-02,2095,5408,9314,217184,24900,42885,-12502,-5873
군포시,2023-03,1532,6140,7520,218716,28072,34382,732,-1794
군포시,2023-04,1667,11202,9883,220383,50829,44844,5062,2363
군포시,2023-05,1347,10575,10521,221730,47693,47449,-627,638
군포시,2023-06,1279,9909,10070,223009,44433,45155,-666,-451
군포시,2023-07,1569,12145,11034,224578,54079,49132,2236,964
군포시,2023-08,1736,10295,11126,226314,45489,49161,-1850,92
군포시,2023-09,1995,13090,9386,228309,57334,41110,2795,-1740
군포시,2023-10,1716,8270,9571,230025,35952,41608,-4820,185
군포시,2023-11,1337,8125,8968,231362,35118,38761,-145,-603
군포시,2023-12,1332,8678,9180,232694,37293,39450,553,212
김포시,2019-01,0,0,0,0,0,0,0,0
김포시,2019-02,0,0,0,0,0,0,0,0
김포시,2019-03,0,0,0,0,0,0,0,0
김포시,2019-04,0,0,0,0,0,0,0,0
김포시,2019-05,0,0,0,0,0,0,0,0
김포시,2019-06,0,0,0,0,0,0,0,0
김포시,2019-07,0,0,0,0,0,0,0,0
김포시,2019-08,0,0,0,0,0,0,0,0
김포시,2019-09,0,0,0,0,0,0,0,0
김포시,2019-10,0,0,0,0,0,0,0,0
김포시,2019-11,0,0,0,0,0,0,0,0
김포시,2019-12,0,0,0,0,0,0,0,0
김포시,2020-01,0,0,0,0,0,0,0,0
김포시,2020-02,0,0,0,0,0,0,0,0
김포시,2020-03,0,0,0,0,0,0,0,0
김포시,2020-04,0,0,0,0,0,0,0,0
김포시,2020-05,0,0,0,0,0,0,0,0
김포시,2020-06,0,0,0,0,0,0,0,0
김포시,2020-07,0,0,0,0,0,0,0,0
김포시,2020-08,0,0,0,0,0,0,0,0
김포시,2020-09,0,0,0,0,0,0,0,0
김포시,2020-10,0,0,0,0,0,0,0,0
김포시,2020-11,0,0,0,0,0,0,0,0
김포시,2020-12,0,0,0,0,0,0,0,0
김포시,2021-01,0,0,0,0,0,0,0,0
김포시,2021-02,0,0,0,0,0,0,0,0
김포시,2021-03,0,0,0,0,0,0,0,0
김포시,2021-04,0,0,0,0,0,0,0,0
김포시,2021-05,0,0,0,0,0,0,0,0
김포시,2021-06,0,0,0,0,0,0,0,0
김포시,2021-07,0,0,0,0,0,0,0,0
김포시,2021-08,0,0,0,0,0,0,0,0
김포시,2021-09,0,0,0,0,0,0,0,0
김포시,2021-10,0,0,0,0,0,0,0,0
김포시,2021-11,0,0,0,0,0,0,0,0
김포시,2021-12,0,0,0,0,0,0,0,0
김포시,2022-01,0,0,0,0,0,0,0,0
김포시,2022-02,0,0,0,0,0,0,0,0
김포시,2022-03,0,0,0,0,0,0,0,0
김포시,2022-04,0,0,0,0,0,0,0,0
김포시,2022-05,0,0,0,0,0,0,0,0
김포시,2022-06,0,0,0,0,0,0,0,0
김포시,2022-07,0,0,0,0,0,0,0,0
김포시,2022-08,0,0,0,0,0,0,0,0
김포시,2022-09,0,0,0,0,0,0,0,0
김포시,2022-10,0,0,0,0,0,0,0,0
김포시,2022-11,0,0,0,0,0,0,0,0
김포시,2022-12,0,0,0,0,0,0,0,0
김포시,2023-01,6250,14882,21775,6250,2381120,3484000,14882,21775
김포시,2023-02,3245,10589,15272,9495,1115218,1608425,-4293,-6503
김포시,2023-03,3251,11448,13784,12746,898164,1081437,859,-1488
김포시,2023-04,2286,13871,12927,15032,922764,859965,2423,-857
김포시,2023-07,0,11564,10489,15032,769292,697778,-2307,-2438
김포시,2023-08,0,12540,10011,15032,834220,665979,976,-478
김포시,2023-09,12549,17092,14398,27581,619701,522026,4552,4387
김포시,2023-10,0,11750,13489,27581,426017,489068,-5342,-909
김포시,2023-11,1491,11452,12226,29072,393918,420542,-298,-1263
김포시,2023-12,2092,15186,13775,31164,487293,442016,3734,1549
남양주시,2019-01,0,0,0,0,0,0,0,0
남양주시,2019-02,0,0,0,0,0,0,0,0
남양주시,2019-03,0,0,0,0,0,0,0,0
남양주시,2019-04,714,188,8,714,263305,11204,188,8
남양주시,2019-05,8926,3084,978,9640,319917,101452,2896,970
남양주시,2019-06,1911,601,1196,11551,52030,103540,-2483,218
남양주시,2019-07,3630,2021,1383,15181,133126,91100,1420,187
남양주시,2019-08,1643,645,1403,16824,38338,83392,-1376,20
남양주시,2019-09,2297,1644,1233,19121,85978,64484,999,-170
남양주시,2019-10,4396,3434,1922,23517,146022,81728,1790,689
남양주시,2019-11,2146,1571,2183,25663,61216,85064,-1863,261
남양주시,2019-12,4123,3936,2669,29786,132142,89605,2365,486
남양주시,2020-01,3842,2468,2822,33628,73391,83918,-1468,153
남양주시,2020-02,3432,3016,2536,37060,81381,68429,548,-286
남양주시,2020-03,4853,3607,2855,41913,86059,68117,591,319
남양주시,2020-04,75201,6028,3984,117114,51471,34018,2421,1129
남양주시,2020-05,31334,9153,7633,148448,61657,51418,3125,3649
남양주시,2020-06,5399,8817,7722,153847,57310,50192,-336,89
남양주시,2020-07,11473,12018,9986,165320,72695,60404,3201,2264
남양주시,2020-08,4061,7655,9086,169381,45193,53642,-4363,-900
남양주시,2020-09,10994,10885,11080,180375,60346,61427,3230,1994
남양주시,2020-10,5674,11228,12100,186049,60349,65036,343,1020
남양주시,2020-11,5787,12737,12087,191836,66395,63006,1509,-13
남양주시,2020-12,6795,14678,12146,198631,73895,61148,1941,59
남양주시,2021-01,10347,9384,11482,208978,44904,54943,-5294,-664
남양주시,2021-02,17003,11003,8977,225981,48689,39724,1619,-2505
남양주시,2021-03,9903,11003,8977,235884,46645,38056,0,0
남양주시,2021-04,8857,17224,15724,244741,70376,64247,6221,6747
남양주시,2021-05,5381,17191,16884,250122,68730,67503,-33,1160
남양주시,2021-06,18041,22569,20472,268163,84161,76341,5378,3588
남양주시,2021-07,5689,14971,18117,273852,54668,66156,-7598,-2355
남양주시,2021-08,5645,14971,18117,279497,53564,64820,0,0
남양주시,2021-09,12983,14971,18117,292480,51186,61942,0,0
남양주시,2021-10,12136,13794,13864,304616,45283,45513,-1177,-4253
남양주시,2021-11,16882,19395,17522,321498,60326,54501,5601,3658
남양주시,2021-12,6611,18684,19642,328109,56944,59864,-711,2120
남양주시,2022-01,4959,19937,20515,333068,59858,61594,1253,873
남양주시,2022-02,4314,18315,18109,337382,54285,53675,-1622,-2406
남양주시,2022-03,3300,22689,21945,340682,66598,64414,4374,3836
남양주시,2022-04,5107,24129,23207,345789,69779,67113,1440,1262
남양주시,2022-05,3913,23608,24752,349702,67508,70780,-521,1545
남양주시,2022-06,4306,27266,23688,354008,77020,66913,3658,-1064
남양주시,2022-07,6590,22715,21689,360598,62992,60147,-4551,-1999
남양주시,2022-08,5172,13575,23333,365770,37113,63791,-9140,1644
남양주시,2022-09,4684,22975,22583,370454,62018,60960,9400,-750
남양주시,2022-10,4236,21610,22417,374690,57674,59828,-1365,-166
남양주시,2022-11,3439,19313,20646,378129,51075,54600,-2297,-1771
남양주시,2022-12,4073,22715,21689,382202,59431,56747,3402,1043
남양주시,2023-01,5045,22319,22258,387247,57635,57477,-396,569
남양주시,2023-02,5438,17637,19402,392685,44913,49408,-4682,-2856
남양주시,2023-03,4992,21246,21134,397677,53425,53143,3609,1732
남양주시,2023-04,5533,21941,20681,403210,54415,51290,695,-453
남양주시,2023-05,4308,21124,22074,407518,51835,54166,-817,1393
남양주시,2023-06,3866,20639,20589,411384,50169,50048,-485,-1485
남양주시,2023-07,4182,21278,20539,415566,51202,49424,639,-50
남양주시,2023-08,4597,19229,19842,420163,45765,47224,-2049,-697
남양주시,2023-09,5290,26877,22147,425453,63172,52055,7648,2305
남양주시,2023-10,4513,19986,21814,429966,46482,50734,-6891,-333
남양주시,2023-11,3677,19598,20048,433643,45193,46231,-388,-1766
남양주시,2023-12,3970,20541,20013,437613,46938,45732,943,-35
동두천시,2019-01,0,0,0,0,0,0,0,0
동두천시,2019-02,0,0,0,0,0,0,0,0
동두천시,2019-03,0,0,0,0,0,0,0,0
동두천시,2019-04,1245,264,66,1245,212048,53012,264,66
동두천시,2019-05,1260,383,244,2505,152894,97405,119,178
동두천시,2019-06,337,113,210,2842,39760,73891,-270,-34
동두천시,2019-07,590,344,251,3432,100233,73135,231,41
동두천시,2019-08,262,102,205,3694,27612,55495,-242,-46
동두천시,2019-09,421,250,194,4115,60753,47144,148,-11
동두천시,2019-10,588,438,286,4703,93132,60812,188,92
동두천시,2019-11,261,224,305,4964,45124,61442,-214,19
동두천시,2019-12,428,461,341,5392,85497,63241,237,36
동두천시,2020-01,580,495,388,5972,82886,64969,34,47
동두천시,2020-02,415,336,356,6387,52606,55738,-159,-32
동두천시,2020-03,1510,378,380,7897,47866,48119,42,24
동두천시,2020-04,11736,631,398,19633,32139,20271,253,18
동두천시,2020-05,4833,844,779,24466,34496,31840,213,381
동두천시,2020-06,698,752,739,25164,29883,29367,-92,-40
동두천시,2020-07,1351,951,972,26515,35866,36658,199,233
동두천시,2020-08,454,677,769,26969,25102,28514,-274,-203
동두천시,2020-09,999,1045,946,27968,37364,33824,368,177
동두천시,2020-10,849,959,999,28817,33278,34667,-86,53
동두천시,2020-11,5296,1055,922,34113,30926,27027,96,-77
동두천시,2020-12,2279,1600,1345,36392,43965,36958,545,423
동두천시,2021-01,1442,2146,1370,37834,56721,36210,546,25
동두천시,2021-02,4916,1015,1480,42750,23742,34619,-1131,110
동두천시,2021-03,1650,1015,1480,44400,22860,33333,0,0
동두천시,2021-04,1447,1724,1671,45847,37603,36447,709,191
동두천시,2021-05,704,1782,1678,46551,38280,36046,58,7
동두천시,2021-06,2065,2276,2201,48616,46815,45273,494,523
동두천시,2021-07,832,1574,1811,49448,31831,36624,-702,-390
동두천시,2021-08,753,1574,1811,50201,31353,36074,0,0
동두천시,2021-09,1782,1574,1811,51983,30279,34838,0,0
동두천시,2021-10,1228,1781,1352,53211,33470,25408,207,-459
동두천시,2021-11,1634,2069,1928,54845,37724,35153,288,576
동두천시,2021-12,814,2038,2166,55659,36615,38915,-31,238
동두천시,2022-01,510,2068,1999,56169,36817,35589,30,-167
동두천시,2022-02,412,1455,1639,56581,25715,28967,-613,-360
동두천시,2022-03,502,1776,1856,57083,31112,32514,321,217
동두천시,2022-04,503,2004,1975,57586,34800,34296,228,119
동두천시,2022-05,433,2139,2120,58019,36867,36539,135,145
동두천시,2022-06,1814,3961,2204,59833,66200,36835,1822,84
동두천시,2022-07,2215,2802,2797,62048,45158,45078,-1159,593
동두천시,2022-08,947,2399,3574,62995,38082,56734,-403,777
동두천시,2022-09,637,2918,2961,63632,45857,46533,519,-613
동두천시,2022-10,557,2605,2831,64189,40583,44104,-313,-130
동두천시,2022-11,535,2401,2652,64724,37095,40973,-204,-179
동두천시,2022-12,626,2802,2797,65350,42876,42800,401,145
동두천시,2023-01,616,2254,2398,65966,34169,36352,-548,-399
동두천시,2023-02,478,1395,1639,66444,20995,24667,-859,-759
동두천시,2023-03,448,1649,1821,66892,24651,27222,254,182
동두천시,2023-04,512,1896,1789,67404,28128,26541,247,-32
동두천시,2023-05,253,2347,1746,67657,34689,25806,451,-43
동두천시,2023-06,420,2176,2104,68077,31963,30906,-171,358
동두천시,2023-07,434,2205,1969,68511,32184,28739,29,-135
동두천시,2023-08,569,2318,1956,69080,33555,28314,113,-13
동두천시,2023-09,672,2529,2415,69752,36257,34622,211,459
동두천시,2023-10,603,2263,2027,70355,32165,28811,-266,-388
동두천시,2023-11,440,2101,1886,70795,29677,26640,-162,-141
동두천시,2023-12,519,2001,1701,71314,28059,23852,-100,-185
부천시,2019-01,0,0,0,0,0,0,0,0
부천시,2019-02,0,0,0,0,0,0,0,0
부천시,2019-03,8,0,0,8,0,0,0,0
부천시,2019-04,6732,1714,375,6740,254302,55637,1714,375
부천시,2019-05,11617,4024,1720,18357,219207,93697,2310,1345
부천시,2019-06,9827,3963,2912,28184,140611,103321,-61,1192
부천시,2019-07,9659,4603,4058,37843,121634,107232,640,1146
부천시,2019-08,7646,4297,4496,45489,94462,98837,-306,438
부천시,2019-09,6936,5983,4436,52425,114124,84616,1686,-60
부천시,2019-10,6530,4895,4859,58955,83029,82418,-1088,423
부천시,2019-11,2997,2744,4409,61952,44292,71168,-2151,-450
부천시,2019-12,4445,5009,4274,66397,75440,64370,2265,-135
부천시,2020-01,5528,8489,5689,71925,118025,79096,3480,1415
부천시,2020-02,3472,2653,4387,75397,35187,58185,-5836,-1302
부천시,2020-03,7964,8353,5809,83361,100202,69684,5700,1422
부천시,2020-04,51323,9257,6736,134684,68731,50013,904,927
부천시,2020-05,71070,13126,10681,205754,63794,51911,3869,3945
부천시,2020-06,8917,12756,11118,214671,59421,51790,-370,437
부천시,2020-07,14717,18772,15717,229388,81835,68517,6016,4599
부천시,2020-08,6190,11113,14285,235578,47173,60638,-7659,-1432
부천시,2020-09,17027,19720,18638,252605,78066,73783,8607,4353
부천시,2020-10,8810,15281,17677,261415,58454,67620,-4439,-961
부천시,2020-11,8430,16560,16996,269845,61368,62984,1279,-681
부천시,2020-12,8194,12533,14362,278039,45076,51654,-4027,-2634
부천시,2021-01,13605,17389,15270,291644,59624,52358,4856,908
부천시,2021-02,24263,15601,12756,315907,49384,40378,-1788,-2514
부천시,2021-03,13354,15601,12756,329261,47381,38741,0,0
부천시,2021-04,19364,23238,21138,348625,66656,60632,7637,8382
부천시,2021-05,7876,22891,22884,356501,64210,64190,-347,1746
부천시,2021-06,29140,31917,28501,385641,82763,73905,9026,5617
부천시,2021-07,8079,19371,23618,393720,49199,59986,-12546,-4883
부천시,2021-08,7230,19371,23618,400950,48312,58905,0,0
부천시,2021-09,18430,19371,23618,419380,46189,56316,0,0
부천시,2021-10,17573,19007,16906,436953,43498,38690,-364,-6712
부천시,2021-11,14187,23592,21522,451140,52294,47705,4585,4616
부천시,2021-12,7669,24138,24350,458809,52610,53072,546,2828
부천시,2022-01,5960,21482,24632,464769,46220,52998,-2656,282
부천시,2022-02,5363,20392,20051,470132,43375,42649,-1090,-4581
부천시,2022-03,4223,27556,24048,474355,58091,50696,7164,3997
부천시,2022-04,5106,28173,26795,479461,58759,55885,617,2747
부천시,2022-05,4722,27059,28293,484183,55885,58434,-1114,1498
부천시,2022-06,4627,26933,26750,488810,55099,54724,-126,-1543
부천시,2022-07,6036,32124,29482,494846,64917,59578,5191,2732
부천시,2022-08,6899,28110,28504,501745,56024,56809,-4014,-978
부천시,2022-09,5077,30279,29585,506822,59742,58373,2169,1081
부천시,2022-10,4972,29709,28935,511794,58048,56536,-570,-650
부천시,2022-11,4162,27374,28043,515956,53054,54351,-2335,-892
부천시,2022-12,4943,32124,29482,520899,61670,56598,4750,1439
부천시,2023-01,6194,25458,27740,527093,48298,52628,-6666,-1742
부천시,2023-02,5224,18752,22548,532317,35227,42358,-6706,-5192
부천시,2023-03,4209,22423,23428,536526,41792,43666,3671,880
부천시,2023-04,4395,21644,22090,540921,40013,40837,-779,-1338
부천시,2023-05,3032,19693,21539,543953,36203,39597,-1951,-551
부천시,2023-06,2806,18856,19710,546759,34486,36048,-837,-1829
부천시,2023-07,3511,21689,20233,550270,39415,36769,2833,523
부천시,2023-08,4069,17928,18851,554339,32341,34006,-3761,-1382
부천시,2023-09,4202,25577,21362,558541,45792,38246,7649,2511
부천시,2023-10,3650,22233,22068,562191,39547,39253,-3344,706
부천시,2023-11,3032,19752,20288,565223,34945,35893,-2481,-1780
부천시,2023-12,4614,37986,25737,569837,66661,45165,18234,5449
성남시,2019-01,0,4792,3963,0,0,0,0,0
성남시,2019-02,0,4861,3557,0,0,0,69,-406
성남시,2019-03,0,4712,4796,0,0,0,-149,1239
성남시,2019-04,0,5464,4407,0,0,0,752,-389
성남시,2019-05,0,6557,5392,0,0,0,1093,985
성남시,2019-06,0,4957,4948,0,0,0,-1600,-444
성남시,2019-07,0,6224,5186,0,0,0,1267,238
성남시,2019-08,0,5447,5798,0,0,0,-777,612
성남시,2019-09,0,5669,4431,0,0,0,222,-1367
성남시,2019-10,0,7422,6070,0,0,0,1753,1639
성남시,2019-11,0,5633,5731,0,0,0,-1789,-339
성남시,2019-12,0,7684,6374,0,0,0,2051,643
성남시,2020-01,0,5502,5737,0,0,0,-2182,-637
성남시,2020-02,0,5483,4754,0,0,0,-19,-983
성남시,2020-03,0,5474,4760,0,0,0,-9,6
성남시,2020-04,0,42113,15696,0,0,0,36639,10936
성남시,2020-05,0,7785,11694,0,0,0,-34328,-4002
성남시,2020-06,0,5619,8433,0,0,0,-2166,-3261
성남시,2020-07,0,7554,9389,0,0,0,1935,956
성남시,2020-08,0,5528,7192,0,0,0,-2026,-2197
성남시,2020-09,0,5311,7009,0,0,0,-217,-183
성남시,2020-10,0,5340,0,0,0,0,29,-7009
성남시,2020-11,0,5512,5336,0,0,0,172,5336
성남시,2020-12,0,7484,6270,0,0,0,1972,934
성남시,2021-01,0,5184,5690,0,0,0,-2300,-580
성남시,2021-02,0,5392,4652,0,0,0,208,-1038
성남시,2021-03,0,5392,4652,0,0,0,0,0
성남시,2021-04,0,8385,6833,0,0,0,2993,2181
성남시,2021-05,0,6884,6790,0,0,0,-1501,-43
성남시,2021-06,0,5912,5711,0,0,0,-972,-1079
성남시,2021-07,0,5159,5478,0,0,0,-753,-233
성남시,2021-08,0,5159,5478,0,0,0,0,0
성남시,2021-09,0,5159,5478,0,0,0,0,0
성남시,2021-10,0,5358,4748,0,0,0,199,-730
성남시,2021-11,0,5153,4706,0,0,0,-205,-42
성남시,2021-12,0,5775,5753,0,0,0,622,1047
성남시,2022-01,0,4893,5339,0,0,0,-882,-414
성남시,2022-02,0,4929,4378,0,0,0,36,-961
성남시,2022-03,0,5268,5490,0,0,0,339,1112
성남시,2022-04,0,9359,6048,0,0,0,4091,558
성남시,2022-05,0,6745,7518,0,0,0,-2614,1470
성남시,2022-06,0,5925,6321,0,0,0,-820,-1197
성남시,2022-07,0,6860,6489,0,0,0,935,168
성남시,2022-08,0,5775,6619,0,0,0,-1085,130
성남시,2022-09,0,5774,5652,0,0,0,-1,-967
성남시,2022-10,0,6897,6396,0,0,0,1123,744
성남시,2022-11,0,5789,5875,0,0,0,-1108,-521
성남시,2022-12,0,6860,6489,0,0,0,1071,614
성남시,2023-01,14272,46294,23994,14272,3243693,1681193,39434,17505
성남시,2023-02,6369,24008,29861,20641,1163121,1446683,-22286,5867
성남시,2023-03,5012,25388,30652,25653,989669,1194869,1380,791
성남시,2023-04,4330,25554,27830,29983,852282,928192,166,-2822
성남시,2023-05,3971,23551,27933,33954,693614,822671,-2003,103
성남시,2023-06,3738,22632,24298,37692,600445,644646,-919,-3635
성남시,2023-07,16334,22424,23273,54026,415059,430774,-208,-1025
성남시,2023-08,5137,22172,24038,59163,374761,406301,-252,765
성남시,2023-09,16572,60072,28467,75735,793186,375876,37900,4429
성남시,2023-10,5018,24148,28087,80753,299035,347813,-35924,-380
성남시,2023-11,4124,21039,34381,84877,247876,405068,-3109,6294
성남시,2023-12,5135,23175,26395,90012,257465,293238,2136,-7986
수원시,2019-01,0,0,0,0,0,0,0,0
수원시,2019-02,0,0,0,0,0,0,0,0
수원시,2019-03,4,0,0,4,0,0,0,0
수원시,2019-04,4505,924,151,4509,204923,33488,924,151
수원시,2019-05,17303,5567,1917,21812,255226,87887,4643,1766
수원시,2019-06,4973,1344,2083,26785,50177,77767,-4223,166
수원시,2019-07,8832,4603,2782,35617,129236,78108,3259,699
수원시,2019-08,6271,3339,3305,41888,79712,78900,-1264,523
수원시,2019-09,4209,1372,2397,46097,29763,51999,-1967,-908
수원시,2019-10,7390,5550,3240,53487,103763,60575,4178,843
수원시,2019-11,3098,1706,3309,56585,30149,58478,-3844,69
수원시,2019-12,5879,5005,3508,62464,80126,56160,3299,199
수원시,2020-01,5948,4803,3644,68412,70206,53265,-202,136
수원시,2020-02,9069,2178,3042,77481,28110,39261,-2625,-602
수원시,2020-03,13576,7967,4265,91057,87494,46838,5789,1223
수원시,2020-04,203175,15060,8229,294232,51184,27967,7093,3964
수원시,2020-05,74407,17845,15787,368639,48407,42825,2785,7558
수원시,2020-06,13603,17209,15489,382242,45021,40521,-636,-298
수원시,2020-07,21536,18748,18318,403778,46431,45366,1539,2829
수원시,2020-08,7313,12432,14936,411091,30241,36332,-6316,-3382
수원시,2020-09,23091,21953,20079,434182,50561,46245,9521,5143
수원시,2020-10,11603,18829,20931,445785,42237,46953,-3124,852
수원시,2020-11,11491,20901,19871,457276,45707,43455,2072,-1060
수원시,2020-12,11906,23074,20287,469182,49179,43239,2173,416
수원시,2021-01,19139,20073,18991,488321,41106,38890,-3001,-1296
수원시,2021-02,32993,22486,16312,521314,43133,31290,2413,-2679
수원시,2021-03,17865,22486,16312,539179,41704,30253,0,0
수원시,2021-04,25109,27421,24984,564288,48593,44275,4935,8672
수원시,2021-05,12167,26431,26700,576455,45850,46317,-990,1716
수원시,2021-06,34891,39592,35850,611346,64762,58641,13161,9150
수원시,2021-07,9097,25919,30400,620443,41774,48997,-13673,-5450
수원시,2021-08,11777,25919,30400,632220,40996,48084,0,0
수원시,2021-09,20812,25919,30400,653032,39690,46552,0,0
수원시,2021-10,18658,20422,23899,671690,30403,35580,-5497,-6501
수원시,2021-11,24357,37254,31175,696047,53522,44788,16832,7276
수원시,2021-12,11793,38589,35437,707840,54516,50063,1335,4262
수원시,2022-01,10244,35517,37412,718084,49460,52099,-3072,1975
수원시,2022-02,10004,26493,30490,728088,36387,41876,-9024,-6922
수원시,2022-03,10678,32314,33872,738766,43740,45849,5821,3382
수원시,2022-04,8983,34439,34409,747749,46056,46016,2125,537
수원시,2022-05,8029,39625,34373,755778,52429,45480,5186,-36
수원시,2022-06,5957,20577,28285,761735,27013,37132,-19048,-6088
수원시,2022-07,7820,33114,30915,769555,43030,40172,12537,2630
수원시,2022-08,7706,20047,24328,777261,25791,31299,-13067,-6587
수원시,2022-09,8551,53682,33494,785812,68314,42623,33635,9166
수원시,2022-10,7517,28820,31385,793329,36327,39561,-24862,-2109
수원시,2022-11,6009,26159,29572,799338,32725,36995,-2661,-1813
수원시,2022-12,6991,33114,30915,806329,41067,38340,6955,1343
수원시,2023-01,9017,32494,31358,815346,39853,38459,-620,443
수원시,2023-02,8509,20810,30491,823855,25259,37010,-11684,-867
수원시,2023-03,7115,25857,28007,830970,31116,33703,5047,-2484
수원시,2023-04,6963,25954,27098,837933,30973,32339,97,-909
수원시,2023-05,5160,25435,25104,843093,30168,29776,-519,-1994
수원시,2023-06,4590,22087,22457,847683,26055,26492,-3348,-2647
수원시,2023-07,5962,31491,26522,853645,36890,31069,9404,4065
수원시,2023-08,6804,24897,23769,860449,28934,27623,-6594,-2753
수원시,2023-09,9606,42298,25866,870055,48615,29729,17401,2097
수원시,2023-10,8591,25010,25466,878646,28464,28983,-17288,-400
수원시,2023-11,6007,27993,27835,884653,31642,31464,2983,2369
수원시,2023-12,5373,23361,28271,890026,26247,31764,-4632,436
시흥시,2019-01,0,0,0,0,0,0,0,0
시흥시,2019-02,0,0,0,0,0,0,0,0
시흥시,2019-03,0,0,0,0,0,0,0,0
시흥시,2019-04,0,0,0,0,0,0,0,0
시흥시,2019-05,0,0,0,0,0,0,0,0
시흥시,2019-06,0,0,0,0,0,0,0,0
시흥시,2019-07,0,0,0,0,0,0,0,0
시흥시,2019-08,0,0,0,0,0,0,0,0
시흥시,2019-09,0,0,0,0,0,0,0,0
시흥시,2019-10,0,0,0,0,0,0,0,0
시흥시,2019-11,0,0,0,0,0,0,0,0
시흥시,2019-12,0,0,0,0,0,0,0,0
시흥시,2020-01,0,0,0,0,0,0,0,0
시흥시,2020-02,0,0,0,0,0,0,0,0
시흥시,2020-03,0,0,0,0,0,0,0,0
시흥시,2020-04,0,0,0,0,0,0,0,0
시흥시,2020-05,0,0,0,0,0,0,0,0
시흥시,2020-06,0,0,0,0,0,0,0,0
시흥시,2020-07,0,0,0,0,0,0,0,0
시흥시,2020-08,0,0,0,0,0,0,0,0
시흥시,2020-09,0,0,0,0,0,0,0,0
시흥시,2020-10,0,0,0,0,0,0,0,0
시흥시,2020-11,0,0,0,0,0,0,0,0
시흥시,2020-12,0,0,0,0,0,0,0,0
시흥시,2021-01,0,0,0,0,0,0,0,0
시흥시,2021-02,0,0,0,0,0,0,0,0
시흥시,2021-03,0,0,0,0,0,0,0,0
시흥시,2021-04,0,0,0,0,0,0,0,0
시흥시,2021-05,0,0,0,0,0,0,0,0
시흥시,2021-06,0,0,0,0,0,0,0,0
시흥시,2021-07,0,0,0,0,0,0,0,0
시흥시,2021-08,0,0,0,0,0,0,0,0
시흥시,2021-09,0,0,0,0,0,0,0,0
시흥시,2021-10,0,0,0,0,0,0,0,0
시흥시,2021-11,0,0,0,0,0,0,0,0
시흥시,2021-12,0,0,0,0,0,0,0,0
시흥시,2022-01,0,0,0,0,0,0,0,0
시흥시,2022-02,0,0,0,0,0,0,0,0
시흥시,2022-03,0,0,0,0,0,0,0,0
시흥시,2022-04,0,0,0,0,0,0,0,0
시흥시,2022-05,0,0,0,0,0,0,0,0
시흥시,2022-06,0,0,0,0,0,0,0,0
시흥시,2022-07,0,0,0,0,0,0,0,0
시흥시,2022-08,0,0,0,0,0,0,0,0
시흥시,2022-09,0,0,0,0,0,0,0,0
시흥시,2022-10,0,0,0,0,0,0,0,0
시흥시,2022-11,0,0,0,0,0,0,0,0
시흥시,2022-12,0,0,0,0,0,0,0,0
시흥시,2023-01,6140,28471,26818,6140,4636970,4367752,28471,26818
시흥시,2023-02,2900,18436,22655,9040,2039380,2506084,-10035,-4163
시흥시,2023-03,3267,21183,23505,12307,1721215,1909888,2747,850
시흥시,2023-04,2971,21479,22319,15278,1405877,1460858,296,-1186
시흥시,2023-05,2304,21805,22165,17582,1240188,1260664,326,-154
시흥시,2023-06,2236,18962,19439,19818,956806,980875,-2843,-2726
시흥시,2023-07,2518,20224,20879,22336,905444,934768,1262,1440
시흥시,2023-08,2163,21217,21009,24499,866035,857545,993,130
시흥시,2023-09,4831,31468,22058,29330,1072894,752062,10251,1049
시흥시,2023-10,2817,17371,20906,32147,540361,650325,-14097,-1152
시흥시,2023-11,4386,17821,20183,36533,487805,552459,450,-723
시흥시,2023-12,2363,28515,25205,38896,733108,648010,10694,5022
안산시,2019-01,0,0,0,0,0,0,0,0
안산시,2019-02,0,0,0,0,0,0,0,0
안산시,2019-03,3,0,0,3,0,0,0,0
안산시,2019-04,1894,583,119,1897,307327,62730,583,119
안산시,2019-05,9314,2613,1191,11211,233074,106234,2030,1072
안산시,2019-06,3607,1534,1676,14818,103522,113105,-1079,485
안산시,2019-07,5208,3227,2337,20026,161140,116698,1693,661
안산시,2019-08,2168,1190,2201,22194,53618,99170,-2037,-136
안산시,2019-09,3343,2494,1871,25537,97662,73266,1304,-330
안산시,2019-10,4505,3490,2742,30042,116170,91272,996,871
안산시,2019-11,2729,2978,3096,32771,90873,94473,-512,354
안산시,2019-12,4521,4484,3699,37292,120240,99190,1506,603
안산시,2020-01,4540,5766,4216,41832,137837,100784,1282,517
안산시,2020-02,6629,5662,4414,48461,116836,91083,-104,198
안산시,2020-03,9634,6497,5584,58095,111834,96118,835,1170
안산시,2020-04,111340,9215,7535,169435,54386,44471,2718,1951
안산시,2020-05,164206,13076,10221,333641,39191,30634,3861,2686
안산시,2020-06,33989,18862,14286,367630,51307,38859,5786,4065
안산시,2020-07,18535,21188,20519,386165,54867,53135,2326,6233
안산시,2020-08,7413,17843,19984,393578,45335,50775,-3345,-535
안산시,2020-09,9462,25777,25047,403040,63956,62145,7934,5063
안산시,2020-10,6408,24471,25102,409448,59765,61306,-1306,55
안산시,2020-11,5657,28198,25955,415105,67929,62526,3727,853
안산시,2020-12,3858,7370,14147,418963,17591,33766,-20828,-11808
안산시,2021-01,8208,22651,18908,427171,53025,44263,15281,4761
안산시,2021-02,21353,21556,17026,448524,48059,37960,-1095,-1882
안산시,2021-03,14415,21556,17026,462939,46563,36778,0,0
안산시,2021-04,27465,27176,25957,490404,55415,52929,5620,8931
안산시,2021-05,7342,26593,27091,497746,53426,54427,-583,1134
안산시,2021-06,18687,39212,34859,516433,75928,67499,12619,7768
안산시,2021-07,5370,5481,15178,521803,10503,29087,-33731,-19681
안산시,2021-08,4204,5481,15178,526007,10420,28855,0,0
안산시,2021-09,17426,5481,15178,543433,10085,27929,0,0
안산시,2021-10,11318,16002,15998,554751,28845,28838,10521,820
안산시,2021-11,9292,32372,25240,564043,57392,44748,16370,9242
안산시,2021-12,6701,27679,28938,570744,48496,50702,-4693,3698
안산시,2022-01,4177,25796,27974,574921,44868,48657,-1883,-964
안산시,2022-02,3846,24477,23570,578767,42291,40724,-1319,-4404
안산시,2022-03,3561,23988,25875,582328,41193,44433,-489,2305
안산시,2022-04,9911,26637,26309,592239,44976,44422,2649,434
안산시,2022-05,5501,34570,33330,597740,57834,55760,7933,7021
안산시,2022-06,4170,25140,27442,601910,41767,45591,-9430,-5888
안산시,2022-07,10206,6459,10404,612116,10551,16996,-18681,-17038
안산시,2022-08,5160,19903,23149,617276,32243,37501,13444,12745
안산시,2022-09,3891,20195,20888,621167,32511,33627,292,-2261
안산시,2022-10,3689,20648,20602,624856,33044,32970,453,-286
안산시,2022-11,3010,18475,19416,627866,29425,30923,-2173,-1186
안산시,2022-12,2742,6459,10404,630608,10242,16498,-12016,-9012
안산시,2023-01,3808,17983,14799,634416,28345,23326,11524,4395
안산시,2023-02,3380,12004,13227,637796,18821,20738,-5979,-1572
안산시,2023-03,2791,13204,13531,640587,20612,21122,1200,304
안산시,2023-04,2833,14035,13392,643420,21813,20813,831,-139
안산시,2023-05,2294,16533,15489,645714,25604,23987,2498,2097
안산시,2023-06,2096,14751,15044,647810,22770,23222,-1782,-445
안산시,2023-07,2825,16346,15466,650635,25123,23770,1595,422
안산시,2023-08,2717,14463,14440,653352,22136,22101,-1883,-1026
안산시,2023-09,3665,19042,15874,657017,28982,24160,4579,1434
안산시,2023-10,3316,14577,16033,660333,22075,24280,-4465,159
안산시,2023-11,2490,14004,15119,662823,21127,22810,-573,-914
안산시,2023-12,3452,22403,18021,666275,33624,27047,8399,2902
안성시,2019-01,0,0,0,0,0,0,0,0
안성시,2019-02,0,0,0,0,0,0,0,0
안성시,2019-03,597,0,0,597,0,0,0,0
안성시,2019-04,1101,1804,632,1698,1062426,372202,1804,632
안성시,2019-05,2480,810,831,4178,193872,198898,-994,199
안성시,2019-06,1197,782,783,5375,145488,145674,-28,-48
안성시,2019-07,1250,855,941,6625,129056,142037,73,158
안성시,2019-08,1040,807,911,7665,105283,118851,-48,-30
안성시,2019-09,904,933,876,8569,108880,102228,126,-35
안성시,2019-10,1108,1413,1118,9677,146016,115531,480,242
안성시,2019-11,661,971,1156,10338,93925,111820,-442,38
안성시,2019-12,911,1560,1255,11249,138678,111565,589,99
안성시,2020-01,504,708,1088,11753,60239,92572,-852,-167
안성시,2020-02,478,1669,1008,12231,136456,82413,961,-80
안성시,2020-03,1459,734,1140,13690,53615,83272,-935,132
안성시,2020-04,24491,2776,1390,38181,72706,36405,2042,250
안성시,2020-05,13487,2845,2280,51668,55063,44127,69,890
안성시,2020-06,1916,3646,3155,53584,68042,58879,801,875
안성시,2020-07,3033,4979,4253,56617,87941,75118,1333,1098
안성시,2020-08,1227,3370,4194,57844,58260,72505,-1609,-59
안성시,2020-09,3136,5295,5242,60980,86831,85962,1925,1048
안성시,2020-10,1868,4887,5116,62848,77759,81402,-408,-126
안성시,2020-11,2082,5662,5453,64930,87201,83982,775,337
안성시,2020-12,2158,6977,6041,67088,103997,90045,1315,588
안성시,2021-01,3216,4602,5456,70304,65458,77605,-2375,-585
안성시,2021-02,6905,5682,4467,77209,73592,57855,1080,-989
안성시,2021-03,4061,5682,4467,81270,69915,54964,0,0
안성시,2021-04,6904,6790,6627,88174,77006,75158,1108,2160
안성시,2021-05,22546,6604,6181,110720,59645,55825,-186,-446
안성시,2021-06,11843,10253,9465,122563,83654,77225,3649,3284
안성시,2021-07,2854,5462,6053,125417,43550,48262,-4791,-3412
안성시,2021-08,1899,5462,6053,127316,42901,47543,0,0
안성시,2021-09,5708,5462,6053,133024,41060,45503,0,0
안성시,2021-10,3724,4114,4148,136748,30084,30333,-1348,-1905
안성시,2021-11,3365,7226,5054,140113,51572,36070,3112,906
안성시,2021-12,2707,4738,6514,142820,33174,45609,-2488,1460
안성시,2022-01,1849,5864,5644,144669,40533,39013,1126,-870
안성시,2022-02,1104,4418,4785,145773,30307,32825,-1446,-859
안성시,2022-03,904,5317,5499,146677,36249,37490,899,714
안성시,2022-04,1059,5657,5712,147736,38291,38663,340,213
안성시,2022-05,1318,7408,7213,149054,49700,48391,1751,1501
안성시,2022-06,1591,10852,7622,150645,72036,50595,3444,409
안성시,2022-07,1487,7801,7374,152132,51277,48471,-3051,-248
안성시,2022-08,1362,5780,6704,153494,37656,43675,-2021,-670
안성시,2022-09,1569,7420,7361,155063,47851,47471,1640,657
안성시,2022-10,1599,11476,9060,156662,73253,57831,4056,1699
안성시,2022-11,1023,5912,7552,157685,37492,47892,-5564,-1508
안성시,2022-12,1110,7801,7374,158795,49126,46437,1889,-178
안성시,2023-01,1419,8461,6384,160214,52810,39846,660,-990
안성시,2023-02,1148,3880,4786,161362,24045,29660,-4581,-1598
안성시,2023-03,9138,8461,6787,170500,49624,39806,4581,2001
안성시,2023-04,11435,11606,9067,181935,63792,49836,3145,2280
안성시,2023-05,5113,6364,9217,187048,34023,49276,-5242,150
안성시,2023-06,2741,6417,7264,189789,33811,38274,53,-1953
안성시,2023-07,1395,5841,6485,191184,30551,33920,-576,-779
안성시,2023-08,1455,9015,9015,192639,46797,46797,3174,2530
안성시,2023-09,926,5365,7008,193565,27716,36204,-3650,-2007
안성시,2023-10,943,5974,6412,194508,30713,32965,609,-596
안성시,2023-11,787,4607,5509,195295,23589,28208,-1367,-903
안성시,2023-12,975,8836,6844,196270,45019,34870,4229,1335
안양시,2019-01,0,0,0,0,0,0,0,0
안양시,2019-02,0,0,0,0,0,0,0,0
안양시,2019-03,0,0,0,0,0,0,0,0
안양시,2019-04,549,293,4,549,533697,7285,293,4
안양시,2019-05,5365,1509,542,5914,255157,91646,1216,538
안양시,2019-06,898,308,547,6812,45214,80299,-1201,5
안양시,2019-07,3039,1845,792,9851,187290,80397,1537,245
안양시,2019-08,849,227,868,10700,21214,81121,-1618,76
안양시,2019-09,546,173,441,11246,15383,39213,-54,-427
안양시,2019-10,2318,1795,723,13564,132335,53302,1622,282
안양시,2019-11,536,199,826,14100,14113,58581,-1596,103
안양시,2019-12,2080,1808,943,16180,111742,58281,1609,117
안양시,2020-01,498,171,850,16678,10253,50965,-1637,-93
안양시,2020-02,372,158,424,17050,9266,24868,-13,-426
안양시,2020-03,9164,1477,731,26214,56343,27885,1319,307
안양시,2020-04,31880,3377,1811,58094,58129,31173,1900,1080
안양시,2020-05,48308,5164,3812,106402,48532,35826,1787,2001
안양시,2020-06,4918,3966,3543,111320,35627,31827,-1198,-269
안양시,2020-07,10991,5276,5024,122311,43135,41075,1310,1481
안양시,2020-08,4680,4399,4849,126991,34640,38183,-877,-175
안양시,2020-09,14046,7571,6838,141037,53680,48483,3172,1989
안양시,2020-10,7502,7079,7298,148539,47657,49131,-492,460
안양시,2020-11,6979,8133,7378,155518,52296,47441,1054,80
안양시,2020-12,8054,9778,7978,163572,59777,48773,1645,600
안양시,2021-01,10897,7045,7526,174469,40379,43136,-2733,-452
안양시,2021-02,15539,7897,6253,190008,41561,32909,852,-1273
안양시,2021-03,9866,7897,6253,199874,39509,31284,0,0
안양시,2021-04,9471,12027,10196,209345,57450,48704,4130,3943
안양시,2021-05,6260,11550,11226,215605,53570,52067,-477,1030
안양시,2021-06,24608,18086,15676,240213,75291,65258,6536,4450
안양시,2021-07,6904,12393,14098,247117,50150,57049,-5693,-1578
안양시,2021-08,6416,12393,14098,253533,48881,55606,0,0
안양시,2021-09,12292,12393,14098,265825,46620,53034,0,0
안양시,2021-10,10623,5036,6195,276448,18216,22409,-7357,-7903
안양시,2021-11,14144,15435,10502,290592,53115,36140,10399,4307
안양시,2021-12,6964,13843,13262,297556,46522,44569,-1592,2760
안양시,2022-01,5613,13803,14314,303169,45529,47214,-40,1052
안양시,2022-02,5308,13616,12533,308477,44139,40628,-187,-1781
안양시,2022-03,4420,15229,14803,312897,48670,47309,1613,2270
안양시,2022-04,4769,16062,15694,317666,50562,49404,833,891
안양시,2022-05,4629,15304,16348,322295,47484,50723,-758,654
안양시,2022-06,4398,16790,15265,326693,51393,46725,1486,-1083
안양시,2022-07,6894,19121,17178,333587,57319,51494,2331,1913
안양시,2022-08,6165,16315,17432,339752,48020,51308,-2806,254
안양시,2022-09,5021,17722,17190,344773,51401,49858,1407,-242
안양시,2022-10,4685,17808,17195,349458,50958,49204,86,5
안양시,2022-11,3942,16174,16129,353400,45766,45639,-1634,-1066
안양시,2022-12,4500,19121,17178,357900,53425,47996,2947,1049
안양시,2023-01,5670,22863,20567,363570,62884,56569,3742,3389
안양시,2023-02,5258,14409,17652,368828,39066,47859,-8454,-2915
안양시,2023-03,66303,28665,22863,435131,65876,52542,14256,5211
안양시,2023-04,37438,26263,26476,472569,55574,56025,-2402,3613
안양시,2023-05,21679,27256,26026,494248,55146,52657,993,-450
안양시,2023-06,9528,22927,19569,503776,45510,38844,-4329,-6457
안양시,2023-07,5182,23800,27780,508958,46762,54582,873,8211
안양시,2023-08,5510,22103,22903,514468,42962,44517,-1697,-4877
안양시,2023-09,4105,24548,22277,518573,47337,42958,2445,-626
안양시,2023-10,3209,17974,21221,521782,34447,40670,-6574,-1056
안양시,2023-11,2700,17618,19654,524482,33591,37473,-356,-1567
안양시,2023-12,2868,18707,18620,527350,35473,35308,1089,-1034
양주시,2019-01,0,0,0,0,0,0,0,0
양주시,2019-02,0,0,0,0,0,0,0,0
양주시,2019-03,470,198,10,470,421276,21276,198,10
양주시,2019-04,2179,857,293,2649,323518,110607,659,283
양주시,2019-05,2879,1159,750,5528,209659,135672,302,457
양주시,2019-06,1096,695,775,6624,104921,116998,-464,25
양주시,2019-07,1860,1312,1017,8484,154644,119872,617,242
양주시,2019-08,1031,856,1053,9515,89963,110667,-456,36
양주시,2019-09,852,933,918,10367,89997,88550,77,-135
양주시,2019-10,1281,1514,1102,11648,129979,94608,581,184
양주시,2019-11,832,952,1121,12480,76282,89823,-562,19
양주시,2019-12,1187,1531,1249,13667,112021,91388,579,128
양주시,2020-01,1136,1173,1299,14803,79240,87752,-358,50
양주시,2020-02,1094,1629,1251,15897,102472,78694,456,-48
양주시,2020-03,2738,1681,1474,18635,90206,79098,52,223
양주시,2020-04,19929,2079,1678,38564,53910,43512,398,204
양주시,2020-05,15596,2698,2267,54160,49815,41857,619,589
양주시,2020-06,2098,2810,2635,56258,49948,46837,112,368
양주시,2020-07,4015,3831,3422,60273,63560,56775,1021,787
양주시,2020-08,1320,2397,2956,61593,38916,47992,-1434,-466
양주시,2020-09,3090,3503,3426,64683,54156,52966,1106,470
양주시,2020-10,1693,3155,3527,66376,47532,53136,-348,101
양주시,2020-11,1664,3509,3383,68040,51572,49720,354,-144
양주시,2020-12,2036,4690,3738,70076,66927,53342,1181,355
양주시,2021-01,3694,2831,3448,73770,38376,46739,-1859,-290
양주시,2021-02,6544,3394,2614,80314,42259,32547,563,-834
양주시,2021-03,3480,3394,2614,83794,40504,31195,0,0
양주시,2021-04,3774,5022,4655,87568,57349,53158,1628,2041
양주시,2021-05,1963,4902,4822,89531,54751,53858,-120,167
양주시,2021-06,5572,6368,5992,95103,66958,63005,1466,1170
양주시,2021-07,1820,4104,4993,96923,42342,51515,-2264,-999
양주시,2021-08,1820,4104,4993,98743,41562,50565,0,0
양주시,2021-09,3628,4104,4993,102371,40089,48773,0,0
양주시,2021-10,3392,3288,3580,105763,31088,33849,-816,-1413
양주시,2021-11,4277,6241,5070,110040,56715,46074,2953,1490
양주시,2021-12,1989,6126,5856,112029,54682,52272,-115,786
양주시,2022-01,1282,5636,5880,113311,49739,51892,-490,24
양주시,2022-02,1215,4942,5066,114526,43151,44234,-694,-814
양주시,2022-03,1094,6306,6155,115620,54540,53234,1364,1089
양주시,2022-04,1268,5916,6089,116888,50612,52092,-390,-66
양주시,2022-05,1216,5488,6095,118104,46467,51607,-428,6
양주시,2022-06,1628,9551,5963,119732,79769,49802,4063,-132
양주시,2022-07,2673,8881,7068,122405,72554,57742,-670,1105
양주시,2022-08,1960,7441,7783,124365,59831,62581,-1440,715
양주시,2022-09,1609,8263,7585,125974,65592,60210,822,-198
양주시,2022-10,1518,6456,7183,127492,50638,56340,-1807,-402
양주시,2022-11,1178,4818,5484,128670,37444,42620,-1638,-1699
양주시,2022-12,1648,8881,7068,130318,68148,54236,4063,1584
양주시,2023-01,1800,7642,6704,132118,57842,50742,-1239,-364
양주시,2023-02,1755,3450,5066,133873,25770,37841,-4192,-1638
양주시,2023-03,1974,7440,6626,135847,54767,48775,3990,1560
양주시,2023-04,2279,6989,6916,138126,50598,50070,-451,290
양주시,2023-05,1846,8043,7726,139972,57461,55196,1054,810
양주시,2023-06,1657,6599,7241,141629,46593,51126,-1444,-485
양주시,2023-07,1837,7744,7306,143466,53977,50924,1145,65
양주시,2023-08,1569,1811,3955,145035,12486,27269,-5933,-3351
양주시,2023-09,1295,7636,2534,146330,52183,17317,5825,-1421
양주시,2023-10,2321,7806,7192,148651,52512,48381,170,4658
양주시,2023-11,1372,4153,6430,150023,27682,42860,-3653,-762
양주시,2023-12,1424,6327,6190,151447,41776,40872,2174,-240
양평군,2019-01,0,0,0,0,0,0,0,0
양평군,2019-02,0,0,0,0,0,0,0,0
양평군,2019-03,1,0,0,1,0,0,0,0
양평군,2019-04,662,182,52,663,274509,78431,182,52
양평군,2019-05,2307,848,498,2970,285521,167676,666,446
양평군,2019-06,1195,779,726,4165,187034,174309,-69,228
양평군,2019-07,1257,1264,1092,5422,233124,201401,485,366
양평군,2019-08,887,1164,1171,6309,184498,185607,-100,79
양평군,2019-09,729,1235,1170,7038,175475,166240,71,-1
양평군,2019-10,853,1518,1352,7891,192371,171334,283,182
양평군,2019-11,626,1446,1435,8517,169778,168486,-72,83
양평군,2019-12,550,1013,1160,9067,111723,127936,-433,-275
양평군,2020-01,814,1637,1414,9881,165671,143102,624,254
양평군,2020-02,710,1609,1563,10591,151921,147578,-28,149
양평군,2020-03,1429,1915,1849,12020,159317,153826,306,286
양평군,2020-04,12885,2164,1803,24905,86890,72395,249,-46
양평군,2020-05,4568,2315,2077,29473,78546,70471,151,274
양평군,2020-06,963,2709,2573,30436,89006,84538,394,496
양평군,2020-07,1496,3227,3311,31932,101058,103689,518,738
양평군,2020-08,864,3215,3253,32796,98030,99188,-12,-58
양평군,2020-09,2105,4550,4297,34901,130368,123119,1335,1044
양평군,2020-10,1423,5697,4171,36324,156838,114827,1147,-126
양평군,2020-11,3737,6538,5779,40061,163201,144255,841,1608
양평군,2020-12,2074,4525,5907,42135,107392,140192,-2013,128
양평군,2021-01,1692,4616,4771,43827,105323,108859,91,-1136
양평군,2021-02,3704,4462,3998,47531,93875,84113,-154,-773
양평군,2021-03,5670,4462,3998,53201,83870,75148,0,0
양평군,2021-04,2722,7101,7668,55923,126978,137117,2639,3670
양평군,2021-05,1391,5250,5993,57314,91600,104564,-1851,-1675
양평군,2021-06,2380,5738,5872,59694,96123,98368,488,-121
양평군,2021-07,1371,5439,5512,61065,89069,90264,-299,-360
양평군,2021-08,1478,5439,5512,62543,86964,88131,0,0
양평군,2021-09,3116,5439,5512,65659,82837,83948,0,0
양평군,2021-10,2648,4286,4273,68307,62746,62555,-1153,-1239
양평군,2021-11,2214,5629,5103,70521,79820,72361,1343,830
양평군,2021-12,2381,6984,7044,72902,95799,96622,1355,1941
양평군,2022-01,1660,5663,6051,74562,75950,81153,-1321,-993
양평군,2022-02,1040,5048,5026,75602,66770,66479,-615,-1025
양평군,2022-03,977,5645,5704,76579,73714,74485,597,678
양평군,2022-04,1095,5977,5960,77674,76949,76730,332,256
양평군,2022-05,1121,5876,5961,78795,74573,75652,-101,1
양평군,2022-06,1301,11136,6871,80096,139033,85784,5260,910
양평군,2022-07,1787,8466,7803,81883,103391,95294,-2670,932
양평군,2022-08,1322,6029,6936,83205,72459,83360,-2437,-867
양평군,2022-09,1928,8193,7771,85133,96237,91280,2164,835
양평군,2022-10,2798,9595,8098,87931,109119,92094,1402,327
양평군,2022-11,1601,6790,7365,89532,75838,82261,-2805,-733
양평군,2022-12,1361,8466,7803,90893,93142,85848,1676,438
양평군,2023-01,1401,6442,7080,92294,69798,76711,-2024,-723
양평군,2023-02,898,4524,5369,93192,48544,57612,-1918,-1711
양평군,2023-03,813,4940,5401,94005,52550,57454,416,32
양평군,2023-04,963,4962,5133,94968,52249,54049,22,-268
양평군,2023-05,616,4958,5126,95584,51870,53628,-4,-7
양평군,2023-06,984,8899,6505,96568,92152,67361,3941,1379
양평군,2023-07,1230,5925,7019,97798,60584,71770,-2974,514
양평군,2023-08,1139,5609,6156,98937,56692,62221,-316,-863
양평군,2023-09,1317,8076,4975,100254,80555,49623,2467,-1181
양평군,2023-10,1569,5223,6917,101823,51294,67931,-2853,1942
양평군,2023-11,997,5666,6077,102820,55106,59103,443,-840
양평군,2023-12,1272,8847,6865,104092,84992,65951,3181,788
여주시,2019-01,0,0,0,0,0,0,0,0
여주시,2019-02,0,0,0,0,0,0,0,0
여주시,2019-03,106,0,0,106,0,0,0,0
여주시,2019-04,810,232,58,916,253275,63318,232,58
여주시,2019-05,1122,352,233,2038,172718,114327,120,175
여주시,2019-06,471,204,229,2509,81307,91271,-148,-4
여주시,2019-07,763,470,331,3272,143643,101161,266,102
여주시,2019-08,419,236,316,3691,63939,85613,-234,-15
여주시,2019-09,420,273,278,4111,66407,67623,37,-38
여주시,2019-10,608,527,383,4719,111676,81161,254,105
여주시,2019-11,501,459,438,5220,87931,83908,-68,55
여주시,2019-12,938,775,628,6158,125852,101981,316,190
여주시,2020-01,3230,905,742,9388,96399,79037,130,114
여주시,2020-02,1321,874,752,10709,81613,70221,-31,10
여주시,2020-03,1343,978,887,12052,81148,73597,104,135
여주시,2020-04,11540,1385,1071,23592,58706,45396,407,184
여주시,2020-05,6803,1506,1395,30395,49547,45895,121,324
여주시,2020-06,883,1615,1517,31278,51633,48500,109,122
여주시,2020-07,1528,2102,1928,32806,64073,58769,487,411
여주시,2020-08,871,1600,1794,33677,47510,53270,-502,-134
여주시,2020-09,1930,7305,3790,35607,205156,106439,5705,1996
여주시,2020-10,1582,2293,3819,37189,61658,102691,-5012,29
여주시,2020-11,1104,2454,3167,38293,64084,82704,161,-652
여주시,2020-12,1182,3067,3017,39475,77694,76428,613,-150
여주시,2021-01,1615,2304,2573,41090,56072,62618,-763,-444
여주시,2021-02,3502,1903,2020,44592,42675,45299,-401,-553
여주시,2021-03,2011,1903,2020,46603,40834,43344,0,0
여주시,2021-04,2183,3226,3084,48786,66125,63214,1323,1064
여주시,2021-05,943,3077,3131,49729,61875,62961,-149,47
여주시,2021-06,1915,3665,3536,51644,70966,68468,588,405
여주시,2021-07,983,3344,3528,52627,63541,67037,-321,-8
여주시,2021-08,1174,3344,3528,53801,62154,65574,0,0
여주시,2021-09,3318,3344,3528,57119,58544,61765,0,0
여주시,2021-10,2292,2896,2882,59411,48745,48509,-448,-646
여주시,2021-11,2720,9670,4263,62131,155638,68613,6774,1381
여주시,2021-12,1940,3552,6484,64071,55438,101200,-6118,2221
여주시,2022-01,1133,3916,4953,65204,60057,75961,364,-1531
여주시,2022-02,784,3232,3600,65988,48978,54555,-684,-1353
여주시,2022-03,855,4058,4176,66843,60709,62474,826,576
여주시,2022-04,985,4350,4390,67828,64132,64722,292,214
여주시,2022-05,867,6630,4471,68695,96513,65084,2280,81
여주시,2022-06,2036,7866,7031,70731,111210,99404,1236,2560
여주시,2022-07,1521,5093,4996,72252,70489,69146,-2773,-2035
여주시,2022-08,1184,4550,5352,73436,61958,72879,-543,356
여주시,2022-09,1127,9421,6838,74563,126349,91707,4871,1486
여주시,2022-10,938,4612,6151,75501,61085,81469,-4809,-687
여주시,2022-11,854,4578,5316,76355,59956,69622,-34,-835
여주시,2022-12,844,5093,4996,77199,65972,64715,515,-320
여주시,2023-01,931,5965,4622,78130,76347,59157,872,-374
여주시,2023-02,863,3100,3601,78993,39243,45586,-2865,-1021
여주시,2023-03,736,3833,4291,79729,48075,53819,733,690
여주시,2023-04,883,4000,4117,80612,49620,51071,167,-174
여주시,2023-05,1259,6703,3517,81871,81872,42957,2703,-600
여주시,2023-06,769,7135,4646,82640,86338,56219,432,1129
여주시,2023-07,921,4672,4653,83561,55911,55683,-2463,7
여주시,2023-08,837,8141,4763,84398,96459,56434,3469,110
여주시,2023-09,948,3656,3567,85346,42837,41794,-4485,-1196
여주시,2023-10,760,3671,3593,86106,42633,41727,15,26
여주시,2023-11,668,3607,3530,86774,41567,40680,-64,-63
여주시,2023-12,755,7749,3889,87529,88530,44430,4142,359
연천군,2019-01,0,0,0,0,0,0,0,0
연천군,2019-02,0,0,0,0,0,0,0,0
연천군,2019-03,0,0,0,0,0,0,0,0
연천군,2019-04,0,0,0,0,0,0,0,0
연천군,2019-05,233,36,1,233,154506,4291,36,1
연천군,2019-06,1099,285,141,1332,213963,105855,249,140
연천군,2019-07,734,363,271,2066,175701,131171,78,130
연천군,2019-08,766,346,561,2832,122175,198093,-17,290
연천군,2019-09,624,395,69,3456,114293,19965,49,-492
연천군,2019-10,474,416,379,3930,105852,96437,21,310
연천군,2019-11,239,318,358,4169,76277,85871,-98,-21
연천군,2019-12,349,588,399,4518,130146,88313,270,41
연천군,2020-01,1169,550,468,5687,96711,82292,-38,69
연천군,2020-02,355,378,418,6042,62562,69182,-172,-50
연천군,2020-03,512,420,411,6554,64083,62709,42,-7
연천군,2020-04,6508,566,520,13062,43331,39810,146,109
연천군,2020-05,2189,583,572,15251,38227,37505,17,52
연천군,2020-06,355,525,454,15606,33640,29091,-58,-118
연천군,2020-07,517,583,638,16123,36159,39570,58,184
연천군,2020-08,324,488,546,16447,29671,33197,-95,-92
연천군,2020-09,579,701,666,17026,41172,39116,213,120
연천군,2020-10,409,612,658,17435,35101,37740,-89,-8
연천군,2020-11,371,716,709,17806,40211,39818,104,51
연천군,2020-12,365,835,742,18171,45952,40834,119,33
연천군,2021-01,421,787,713,18592,42330,38349,-48,-29
연천군,2021-02,974,597,608,19566,30512,31074,-190,-105
연천군,2021-03,961,597,608,20527,29083,29619,0,0
연천군,2021-04,705,957,878,21232,45073,41352,360,270
연천군,2021-05,604,1256,1016,21836,57519,46528,299,138
연천군,2021-06,1189,1302,1357,23025,56547,58935,46,341
연천군,2021-07,574,1090,1208,23599,46188,51188,-212,-149
연천군,2021-08,454,1090,1208,24053,45316,50222,0,0
연천군,2021-09,375,1090,1208,24428,44620,49451,0,0
연천군,2021-10,614,876,901,25042,34981,35979,-214,-307
연천군,2021-11,682,1249,1046,25724,48553,40662,373,145
연천군,2021-12,841,1849,1634,26565,69602,61509,600,588
연천군,2022-01,495,1334,1427,27060,49297,52734,-515,-207
연천군,2022-02,363,949,1120,27423,34605,40841,-385,-307
연천군,2022-03,543,1200,1237,27966,42909,44232,251,117
연천군,2022-04,472,1308,1294,28438,45994,45502,108,57
연천군,2022-05,708,2218,1353,29146,76099,46421,910,59
연천군,2022-06,1036,1809,2039,30182,59936,67556,-409,686
연천군,2022-07,1183,2529,2316,31365,80631,73840,720,277
연천군,2022-08,731,1911,2565,32096,59540,79916,-618,249
연천군,2022-09,714,3594,2158,32810,109539,65772,1683,-407
연천군,2022-10,652,1231,1234,33462,36787,36877,-2363,-924
연천군,2022-11,523,1848,2370,33985,54376,69736,617,1136
연천군,2022-12,491,2529,2316,34476,73355,67177,681,-54
연천군,2023-01,560,1410,2036,35036,40244,58111,-1119,-280
연천군,2023-02,511,1386,1533,35547,38990,43126,-24,-503
연천군,2023-03,533,3188,2390,36080,88359,66241,1802,857
연천군,2023-04,500,1984,2165,36580,54237,59185,-1204,-225
연천군,2023-05,344,3180,2840,36924,86122,76914,1196,675
연천군,2023-06,519,1952,2215,37443,52132,59156,-1228,-625
연천군,2023-07,469,2050,2132,37912,54072,56235,98,-83
연천군,2023-08,217,3173,2534,38129,83217,66458,1123,402
연천군,2023-09,292,1824,1262,38421,47474,32846,-1349,-1272
연천군,2023-10,597,1965,1265,39018,50361,32420,141,3
연천군,2023-11,783,1819,1197,39801,45702,30074,-146,-68
연천군,2023-12,1228,3142,1228,41029,76579,29930,1323,31
오산시,2019-01,0,0,0,0,0,0,0,0
오산시,2019-02,0,0,0,0,0,0,0,0
오산시,2019-03,1,0,0,1,0,0,0,0
오산시,2019-04,1612,305,81,1613,189088,50216,305,81
오산시,2019-05,3535,1142,574,5148,221833,111499,837,493
오산시,2019-06,1045,347,556,6193,56031,89778,-795,-18
오산시,2019-07,1389,839,625,7582,110656,82432,492,69
오산시,2019-08,1011,410,632,8593,47713,73548,-429,7
오산시,2019-09,1953,1036,715,10546,98236,67798,626,83
오산시,2019-10,1396,976,843,11942,81728,70591,-60,128
오산시,2019-11,820,577,829,12762,45212,64958,-399,-14
오산시,2019-12,1645,1744,1158,14407,121052,80377,1167,329
오산시,2020-01,2052,1782,1367,16459,108269,83054,38,209
오산시,2020-02,1826,1608,1371,18285,87940,74979,-174,4
오산시,2020-03,3536,1941,1611,21821,88951,73827,333,240
오산시,2020-04,61363,3117,2291,83184,37471,27541,1176,680
오산시,2020-05,44847,4115,3207,128031,32140,25048,998,916
오산시,2020-06,8013,6245,4680,136044,45904,34400,2130,1473
오산시,2020-07,5429,4222,5654,141473,29843,39965,-2023,974
오산시,2020-08,2185,5805,5204,143658,40408,36224,1583,-450
오산시,2020-09,3028,7542,7244,146686,51415,49384,1737,2040
오산시,2020-10,1937,6527,6916,148623,43916,46533,-1015,-328
오산시,2020-11,2079,7498,7135,150702,49753,47345,971,219
오산시,2020-12,2711,9152,8180,153413,59655,53320,1654,1045
오산시,2021-01,3323,7185,7671,156736,45841,48942,-1967,-509
오산시,2021-02,8770,7740,6353,165506,46765,38385,555,-1318
오산시,2021-03,5810,7740,6353,171316,45179,37083,0,0
오산시,2021-04,8405,10478,10565,179721,58301,58785,2738,4212
오산시,2021-05,2682,9951,10392,182403,54555,56972,-527,-173
오산시,2021-06,5475,13004,12522,187878,69215,66649,3053,2130
오산시,2021-07,2452,11583,11397,190330,60857,59880,-1421,-1125
오산시,2021-08,2259,11583,11397,192589,60143,59177,0,0
오산시,2021-09,5878,11583,11397,198467,58362,57425,0,0
오산시,2021-10,4271,5531,5272,202738,27281,26004,-6052,-6125
오산시,2021-11,3897,11793,9104,206635,57071,44058,6262,3832
오산시,2021-12,2349,10480,10444,208984,50147,49975,-1313,1340
오산시,2022-01,1880,8590,9857,210864,40737,46745,-1890,-587
오산시,2022-02,1745,8155,8241,212609,38356,38761,-435,-1616
오산시,2022-03,1800,9335,9403,214409,43538,43855,1180,1162
오산시,2022-04,1804,9573,9538,216213,44275,44113,238,135
오산시,2022-05,1748,7918,9124,217961,36327,41860,-1655,-414
오산시,2022-06,1501,7221,7444,219462,32903,33919,-697,-1680
오산시,2022-07,2245,7631,5690,221707,34419,25664,410,-1754
오산시,2022-08,1937,8444,8810,223644,37756,39392,813,3120
오산시,2022-09,1535,7599,7569,225179,33746,33613,-845,-1241
오산시,2022-10,1574,6768,6683,226753,29847,29472,-831,-886
오산시,2022-11,1051,3761,4269,227804,16509,18739,-3007,-2414
오산시,2022-12,1128,7631,5690,228932,33333,24854,3870,1421
오산시,2023-01,1415,6574,6001,230347,28539,26051,-1057,311
오산시,2023-02,1260,3590,4906,231607,15500,21182,-2984,-1095
오산시,2023-03,1114,4538,4980,232721,19499,21399,948,74
오산시,2023-04,1304,4570,4861,234025,19527,20771,32,-119
오산시,2023-05,1058,4329,4819,235083,18414,20499,-241,-42
오산시,2023-06,1136,6681,5094,236219,28283,21564,2352,275
오산시,2023-07,1282,7187,5516,237501,30260,23225,506,422
오산시,2023-08,1326,5768,5428,238827,24151,22727,-1419,-88
오산시,2023-09,1391,5724,5619,240218,23828,23391,-44,191
오산시,2023-10,1341,6286,5638,241559,26022,23340,562,19
오산시,2023-11,1091,6043,5303,242650,24904,21854,-243,-335
오산시,2023-12,1007,5907,5392,243657,24243,22129,-136,89
용인시,2019-01,0,0,0,0,0,0,0,0
용인시,2019-02,0,0,0,0,0,0,0,0
용인시,2019-03,0,0,0,0,0,0,0,0
용인시,2019-04,2167,685,78,2167,316105,35994,685,78
용인시,2019-05,10678,3419,986,12845,266173,76761,2734,908
용인시,2019-06,3638,983,1596,16483,59637,96827,-2436,610
용인시,2019-07,5755,3105,1845,22238,139625,82966,2122,249
용인시,2019-08,3006,1065,2049,25244,42188,81167,-2040,204
용인시,2019-09,4293,2851,1866,29537,96523,63175,1786,-183
용인시,2019-10,4852,3541,2475,34389,102968,71970,690,609
용인시,2019-11,1976,1341,2460,36365,36876,67647,-2200,-15
용인시,2019-12,4151,3778,2599,40516,93247,64147,2437,139
용인시,2020-01,5445,4286,3294,45961,93252,71669,508,695
용인시,2020-02,5842,3361,2783,51803,64880,53722,-925,-511
용인시,2020-03,12089,4982,3672,63892,77975,57471,1621,889
용인시,2020-04,158406,10157,6129,222298,45690,27571,5175,2457
용인시,2020-05,64699,13264,10642,286997,46216,37080,3107,4513
용인시,2020-06,7423,14282,12874,294420,48508,43726,1018,2232
용인시,2020-07,19808,16461,16032,314228,52385,51020,2179,3158
용인시,2020-08,6460,10857,12715,320688,33855,39649,-5604,-3317
용인시,2020-09,20096,18206,16973,340784,53423,49805,7349,4258
용인시,2020-10,10791,16837,18342,351575,47890,52170,-1369,1369
용인시,2020-11,9835,18248,17446,361410,50491,48272,1411,-896
용인시,2020-12,8346,12873,13692,369756,34814,37029,-5375,-3754
용인시,2021-01,16455,21857,17042,386211,56593,44126,8984,3350
용인시,2021-02,27846,20271,15622,414057,48957,37729,-1586,-1420
용인시,2021-03,15668,20271,15622,429725,47172,36353,0,0
용인시,2021-04,16642,29468,26457,446367,66017,59271,9197,10835
용인시,2021-05,9207,29564,27831,455574,64893,61089,96,1374
용인시,2021-06,32520,35669,33556,488094,73078,68749,6105,5725
용인시,2021-07,10259,25628,30261,498353,51425,60722,-10041,-3295
용인시,2021-08,9196,25628,30261,507549,50493,59621,0,0
용인시,2021-09,16436,25628,30261,523985,48909,57751,0,0
용인시,2021-10,19343,10123,8993,543328,18631,16551,-15505,-21268
용인시,2021-11,22134,27893,21318,565462,49327,37700,17770,12325
용인시,2021-12,10698,25918,26265,576160,44984,45586,-1975,4947
용인시,2022-01,8194,40313,32251,584354,68987,55190,14395,5986
용인시,2022-02,7820,18346,24437,592174,30980,41266,-21967,-7814
용인시,2022-03,8018,31332,29008,600192,52203,48331,12986,4571
용인시,2022-04,7995,30988,31158,608187,50951,51230,-344,2150
용인시,2022-05,7381,28100,30166,615568,45648,49005,-2888,-992
용인시,2022-06,6416,32121,28498,621984,51642,45817,4021,-1668
용인시,2022-07,10137,31090,29227,632121,49183,46236,-1031,729
용인시,2022-08,7151,19774,25128,639272,30932,39307,-11316,-4099
용인시,2022-09,6502,36166,26942,645774,56004,41720,16392,1814
용인시,2022-10,6802,30541,29426,652576,46800,45092,-5625,2484
용인시,2022-11,5515,25587,27971,658091,38880,42503,-4954,-1455
용인시,2022-12,6468,31090,29227,664559,46782,43979,5503,1256
용인시,2023-01,8513,30756,28917,673072,45694,42962,-334,-310
용인시,2023-02,7487,19537,24438,680559,28707,35908,-11219,-4479
용인시,2023-03,9035,24606,26149,689594,35681,37919,5069,1711
용인시,2023-04,6541,26687,25694,696135,38335,36909,2081,-455
용인시,2023-05,4543,22008,25190,700678,31409,35950,-4679,-504
용인시,2023-06,4703,24576,24691,705381,34840,35003,2568,-499
용인시,2023-07,4969,23891,23725,710350,33632,33399,-685,-966
용인시,2023-08,5025,19780,21780,715375,27649,30445,-4111,-1945
용인시,2023-09,8148,51549,28716,723523,71247,39689,31769,6936
용인시,2023-10,7717,40087,36191,731240,54820,49492,-11462,7475
용인시,2023-11,6080,34738,33253,737320,47113,45099,-5349,-2938
용인시,2023-12,6464,40966,35786,743784,55077,48113,6228,2533
의왕시,2019-01,0,0,0,0,0,0,0,0
의왕시,2019-02,0,0,0,0,0,0,0,0
의왕시,2019-03,0,0,0,0,0,0,0,0
의왕시,2019-04,0,0,0,0,0,0,0,0
의왕시,2019-05,1490,439,123,1490,294630,82550,439,123
의왕시,2019-06,267,86,159,1757,48947,90495,-353,36
의왕시,2019-07,789,482,211,2546,189316,82875,396,52
의왕시,2019-08,202,60,234,2748,21834,85152,-422,23
의왕시,2019-09,113,30,110,2861,10485,38448,-30,-124
의왕시,2019-10,662,483,179,3523,137099,50808,453,69
의왕시,2019-11,150,54,231,3673,14701,62891,-429,52
의왕시,2019-12,555,487,244,4228,115184,57710,433,13
의왕시,2020-01,2370,545,388,6598,82600,58805,58,144
의왕시,2020-02,864,223,366,7462,29884,49048,-322,-22
의왕시,2020-03,2931,691,451,10393,66487,43394,468,85
의왕시,2020-04,6064,985,608,16457,59852,36944,294,157
의왕시,2020-05,14234,1573,1103,30691,51252,35938,588,495
의왕시,2020-06,2326,1204,1155,33017,36466,34981,-369,52
의왕시,2020-07,3643,1553,1491,36660,42362,40671,349,336
의왕시,2020-08,1608,1247,1430,38268,32585,37368,-306,-61
의왕시,2020-09,3965,2166,1962,42233,51286,46456,919,532
의왕시,2020-10,2363,2014,2108,44596,45161,47268,-152,146
의왕시,2020-11,2181,2232,1970,46777,47715,42114,218,-138
의왕시,2020-12,2559,2823,2209,49336,57219,44774,591,239
의왕시,2021-01,3820,2233,2316,53156,42008,43569,-590,107
의왕시,2021-02,5412,2491,1891,58568,42531,32287,258,-425
의왕시,2021-03,2911,2491,1891,61479,40517,30758,0,0
의왕시,2021-04,2852,3604,3082,64331,56022,47908,1113,1191
의왕시,2021-05,2091,3529,3460,66422,53129,52091,-75,378
의왕시,2021-06,8533,5404,4683,74955,72096,62477,1875,1223
의왕시,2021-07,2484,3919,4312,77439,50607,55682,-1485,-371
의왕시,2021-08,2503,3919,4312,79942,49023,53939,0,0
의왕시,2021-09,3935,3919,4312,83877,46723,51408,0,0
의왕시,2021-10,4286,2346,2353,88163,26609,26689,-1573,-1959
의왕시,2021-11,3666,4607,3545,91829,50169,38604,2261,1192
의왕시,2021-12,2256,4535,4346,94085,48201,46192,-72,801
의왕시,2022-01,2112,4270,4639,96197,44388,48223,-265,293
의왕시,2022-02,1855,4081,3933,98052,41620,40111,-189,-706
의왕시,2022-03,1825,4887,4746,99877,48930,47518,806,813
의왕시,2022-04,2084,5174,5020,101961,50744,49234,287,274
의왕시,2022-05,2090,5126,5416,104051,49264,52051,-48,396
의왕시,2022-06,1988,5253,5128,106039,49538,48359,127,-288
의왕시,2022-07,2537,4463,3946,108576,41104,36343,-790,-1182
의왕시,2022-08,2361,5169,5286,110937,46594,47648,706,1340
의왕시,2022-09,1745,5386,5198,112682,47798,46129,217,-88
의왕시,2022-10,1866,5562,5128,114548,48556,44767,176,-70
의왕시,2022-11,1181,2719,3887,115729,23494,33587,-2843,-1241
의왕시,2022-12,1023,4463,3946,116752,38226,33798,1744,59
의왕시,2023-01,1503,3332,3827,118255,28176,32362,-1131,-119
의왕시,2023-02,1130,2369,4150,119385,19843,34761,-963,323
의왕시,2023-03,987,2677,2862,120372,22239,23776,308,-1288
의왕시,2023-04,979,2614,2656,121351,21540,21886,-63,-206
의왕시,2023-05,845,2459,2368,122196,20123,19378,-155,-288
의왕시,2023-06,784,2836,2652,122980,23060,21564,377,284
의왕시,2023-07,1026,3048,2749,124006,24579,22168,212,97
의왕시,2023-08,1086,2282,2588,125092,18242,20688,-766,-161
의왕시,2023-09,1507,4133,2892,126599,32646,22843,1851,304
의왕시,2023-10,1333,4133,3461,127932,32306,27053,0,569
의왕시,2023-11,973,3596,3479,128905,27896,26988,-537,18
의왕시,2023-12,989,3912,3807,129894,30116,29308,316,328
의정부시,2019-01,0,0,0,0,0,0,0,0
의정부시,2019-02,0,0,0,0,0,0,0,0
의정부시,2019-03,0,0,0,0,0,0,0,0
의정부시,2019-04,844,196,15,844,232227,17772,196,15
의정부시,2019-05,6940,2144,661,7784,275436,84917,1948,646
의정부시,2019-06,1648,452,964,9432,47921,102205,-1692,303
의정부시,2019-07,2572,1529,944,12004,127374,78640,1077,-20
의정부시,2019-08,1939,990,1285,13943,71003,92160,-539,341
의정부시,2019-09,1747,1258,1036,15690,80178,66029,268,-249
의정부시,2019-10,2374,1674,1093,18064,92670,60507,416,57
의정부시,2019-11,1201,995,1497,19265,51648,77705,-679,404
의정부시,2019-12,2452,2341,1562,21717,107795,71925,1346,65
의정부시,2020-01,2950,1562,1722,24667,63323,69809,-779,160
의정부시,2020-02,1801,1451,1447,26468,54820,54669,-111,-275
의정부시,2020-03,3171,1644,1553,29639,55467,52397,193,106
의정부시,2020-04,19800,2879,1960,49439,58233,39644,1235,407
의정부시,2020-05,44287,4900,3905,93726,52280,41663,2021,1945
의정부시,2020-06,3665,3906,3776,97391,40106,38771,-994,-129
의정부시,2020-07,8562,5615,5038,105953,52995,47549,1709,1262
의정부시,2020-08,2469,3544,4258,108422,32687,39272,-2071,-780
의정부시,2020-09,8245,6186,5754,116667,53022,49319,2642,1496
의정부시,2020-10,4108,5722,6058,120775,47377,50159,-464,304
의정부시,2020-11,3801,6387,6024,124576,51269,48356,665,-34
의정부시,2020-12,4888,6586,6113,129464,50871,47217,199,89
의정부시,2021-01,8162,5425,5429,137626,39418,39447,-1161,-684
의정부시,2021-02,16159,8238,5773,153785,53568,37539,2813,344
의정부시,2021-03,7582,8238,5773,161367,51051,35775,0,0
의정부시,2021-04,5931,9076,8167,167298,54250,48817,838,2394
의정부시,2021-05,3583,8549,8559,170881,50028,50087,-527,392
의정부시,2021-06,13781,12494,11115,184662,67658,60191,3945,2556
의정부시,2021-07,3789,8078,9662,188451,42865,51270,-4416,-1453
의정부시,2021-08,3612,8078,9662,192063,42059,50306,0,0
의정부시,2021-09,9374,8078,9662,201437,40101,47965,0,0
의정부시,2021-10,8872,7042,7127,210309,33484,33888,-1036,-2535
의정부시,2021-11,10098,9870,8723,220407,44780,39576,2828,1596
의정부시,2021-12,4184,8612,9320,224591,38345,41497,-1258,597
의정부시,2022-01,2662,9465,9746,227253,41649,42886,853,426
의정부시,2022-02,2609,8451,8163,229862,36765,35512,-1014,-1583
의정부시,2022-03,2166,9957,9631,232028,42912,41507,1506,1468
의정부시,2022-04,2906,10953,10190,234934,46621,43373,996,559
의정부시,2022-05,2367,9599,10542,237301,40450,44424,-1354,352
의정부시,2022-06,2841,12577,9798,240142,52373,40800,2978,-744
의정부시,2022-07,5792,10274,10020,245934,41775,40742,-2303,222
의정부시,2022-08,3401,10502,12252,249335,42120,49138,228,2232
의정부시,2022-09,2523,10648,11234,251858,42277,44604,146,-1018
의정부시,2022-10,2576,11303,11031,254434,44424,43355,655,-203
의정부시,2022-11,2151,9109,9867,256585,35500,38455,-2194,-1164
의정부시,2022-12,2623,10274,10020,259208,39636,38656,1165,153
의정부시,2023-01,3007,10624,10107,262215,40516,38544,350,87
의정부시,2023-02,2643,7310,8164,264858,27599,30824,-3314,-1943
의정부시,2023-03,2502,9015,9102,267360,33718,34043,1705,938
의정부시,2023-04,2576,9326,9161,269936,34548,33937,311,59
의정부시,2023-05,1184,8691,9170,271120,32055,33822,-635,9
의정부시,2023-06,1505,7432,8021,272625,27260,29421,-1259,-1149
의정부시,2023-07,1208,6116,6635,273833,22334,24230,-1316,-1386
의정부시,2023-08,878,5015,5530,274711,18255,20130,-1101,-1105
의정부시,2023-09,1786,5302,4761,276497,19175,17218,287,-769
의정부시,2023-10,1077,5411,5157,277574,19493,18578,109,396
의정부시,2023-11,609,4973,5078,278183,17876,18254,-438,-79
의정부시,2023-12,840,5659,5258,279023,20281,18844,686,180
이천시,2019-01,0,0,0,0,0,0,0,0
이천시,2019-02,0,0,0,0,0,0,0,0
이천시,2019-03,0,0,0,0,0,0,0,0
이천시,2019-04,1512,277,29,1512,183201,19179,277,29
이천시,2019-05,1829,576,297,3341,172403,88895,299,268
이천시,2019-06,1076,738,379,4417,167081,85804,162,82
이천시,2019-07,1253,1029,538,5670,181481,94885,291,159
이천시,2019-08,975,549,633,6645,82618,95259,-480,95
이천시,2019-09,1390,539,743,8035,67081,92470,-10,110
이천시,2019-10,1305,1173,749,9340,125588,80192,634,6
이천시,2019-11,520,400,790,9860,40567,80121,-773,41
이천시,2019-12,1298,1457,859,11158,130578,76985,1057,69
이천시,2020-01,1385,975,993,12543,77732,79167,-482,134
이천시,2020-02,1272,1197,911,13815,86644,65942,222,-82
이천시,2020-03,1881,1505,1027,15696,95884,65430,308,116
이천시,2020-04,15752,1505,1296,31448,47856,41210,0,269
이천시,2020-05,17625,2874,1963,49073,58565,40001,1369,667
이천시,2020-06,1966,3900,2571,51039,76412,50373,1026,608
이천시,2020-07,3343,4255,3857,54382,78242,70924,355,1286
이천시,2020-08,1285,2456,3194,55667,44119,57376,-1799,-663
이천시,2020-09,2797,3787,3687,58464,64774,63064,1331,493
이천시,2020-10,1567,4039,3981,60031,67281,66315,252,294
이천시,2020-11,1608,4167,4331,61639,67603,70263,128,350
이천시,2020-12,1726,4954,4311,63365,78181,68034,787,-20
이천시,2021-01,3920,3582,4081,67285,53236,60652,-1372,-230
이천시,2021-02,7372,3633,3211,74657,48662,43010,51,-870
이천시,2021-03,3254,3633,3211,77911,46630,41213,0,0
이천시,2021-04,3609,5484,5157,81520,67271,63260,1851,1946
이천시,2021-05,1695,5573,5693,83215,66971,68413,89,536
이천시,2021-06,5543,7939,6890,88758,89445,77626,2366,1197
이천시,2021-07,2371,6691,6813,91129,73423,74762,-1248,-77
이천시,2021-08,2283,6691,6813,93412,71628,72934,0,0
이천시,2021-09,5274,6691,6813,98686,67800,69037,0,0
이천시,2021-10,7940,4924,5017,106626,46180,47052,-1767,-1796
이천시,2021-11,53779,8662,5129,160405,54000,31975,3738,112
이천시,2021-12,11511,7313,8996,171916,42538,52327,-1349,3867
이천시,2022-01,3182,8469,12200,175098,48367,69675,1156,3204
이천시,2022-02,1045,7425,7470,176143,42153,42408,-1044,-4730
이천시,2022-03,928,8463,8361,177071,47794,47218,1038,891
이천시,2022-04,1092,9371,9014,178163,52597,50594,908,653
이천시,2022-05,1549,10584,10449,179712,58894,58143,1213,1435
이천시,2022-06,1505,11251,10110,181217,62085,55789,667,-339
이천시,2022-07,2714,11988,12362,183931,65176,67209,737,2252
이천시,2022-08,1961,10430,13089,185892,56107,70411,-1558,727
이천시,2022-09,2011,12200,13249,187903,64927,70509,1770,160
이천시,2022-10,1530,16257,11818,189433,85819,62386,4057,-1431
이천시,2022-11,1501,9665,12835,190934,50619,67222,-6592,1017
이천시,2022-12,1394,11988,12362,192328,62331,64275,2323,-473
이천시,2023-01,1414,13135,11074,193742,67796,57158,1147,-1288
이천시,2023-02,1283,7190,7470,195025,36867,38302,-5945,-3604
이천시,2023-03,1183,8705,9719,196208,44366,49534,1515,2249
이천시,2023-04,2245,17978,13638,198453,90590,68721,9273,3919
이천시,2023-05,1622,9489,12823,200075,47427,64090,-8489,-815
이천시,2023-06,998,8189,10535,201073,40726,52393,-1300,-2288
이천시,2023-07,1507,15279,11503,202580,75422,56782,7090,968
이천시,2023-08,1424,9896,10260,204004,48508,50293,-5383,-1243
이천시,2023-09,2040,17842,11622,206044,86593,56405,7946,1362
이천시,2023-10,1363,9393,10149,207407,45287,48932,-8449,-1473
이천시,2023-11,1133,9371,9493,208540,44936,45521,-22,-656
이천시,2023-12,1739,18373,11385,210279,87374,54142,9002,1892
파주시,2019-01,0,0,0,0,0,0,0,0
파주시,2019-02,0,0,0,0,0,0,0,0
파주시,2019-03,0,0,0,0,0,0,0,0
파주시,2019-04,51,6,1,51,117647,19607,6,1
파주시,2019-05,3573,1167,301,3624,322019,83057,1161,300
파주시,2019-06,1976,429,528,5600,76607,94285,-738,227
파주시,2019-07,5068,2143,945,10668,200881,88582,1714,417
파주시,2019-08,2174,600,1221,12842,46721,95078,-1543,276
파주시,2019-09,2269,986,899,15111,65250,59493,386,-322
파주시,2019-10,3192,2352,1433,18303,128503,78293,1366,534
파주시,2019-11,1179,675,1398,19482,34647,71758,-1677,-35
파주시,2019-12,3316,2656,1731,22798,116501,75927,1981,333
파주시,2020-01,2962,1797,1906,25760,69759,73990,-859,175
파주시,2020-02,3160,2167,1798,28920,74930,62171,370,-108
파주시,2020-03,6184,2285,2056,35104,65092,58568,118,258
파주시,2020-04,41415,3350,2651,76519,43779,34644,1065,595
파주시,2020-05,21202,4291,3572,97721,43910,36553,941,921
파주시,2020-06,3354,4195,4004,101075,41503,39614,-96,432
파주시,2020-07,7243,5750,5375,108318,53084,49622,1555,1371
파주시,2020-08,2646,4218,4501,110964,38012,40562,-1532,-874
파주시,2020-09,7569,6867,6330,118533,57933,53402,2649,1829
파주시,2020-10,4621,7079,7365,123154,57480,59803,212,1035
파주시,2020-11,4857,7968,7365,128011,62244,57534,889,0
파주시,2020-12,5470,9775,8328,133481,73231,62390,1807,963
파주시,2021-01,7290,7299,7823,140771,51850,55572,-2476,-505
파주시,2021-02,12210,7111,6135,152981,46482,40103,-188,-1688
파주시,2021-03,8565,7111,6135,161546,44018,37976,0,0
파주시,2021-04,8553,11397,10552,170099,67002,62034,4286,4417
파주시,2021-05,10829,9704,9123,180928,53634,50423,-1693,-1429
파주시,2021-06,16942,14558,13409,197870,73573,67766,4854,4286
파주시,2021-07,5138,11450,12849,203008,56401,63293,-3108,-560
파주시,2021-08,4520,11450,12849,207528,55173,61914,0,0
파주시,2021-09,10373,11450,12849,217901,52546,58967,0,0
파주시,2021-10,9437,9376,9257,227338,41242,40719,-2074,-3592
파주시,2021-11,11399,13931,11522,238737,58352,48262,4555,2265
파주시,2021-12,4539,9301,12034,243276,38232,49466,-4630,512
파주시,2022-01,3549,13746,12764,246825,55691,51712,4445,730
파주시,2022-02,2977,11999,11408,249802,48034,45668,-1747,-1356
파주시,2022-03,2828,14028,13641,252630,55527,53995,2029,2233
파주시,2022-04,3051,14590,14338,255681,57063,56077,562,697
파주시,2022-05,2818,13886,14522,258499,53717,56178,-704,184
파주시,2022-06,2542,13775,13704,261041,52769,52497,-111,-818
파주시,2022-07,5397,9437,11143,266438,35419,41822,-4338,-2561
파주시,2022-08,4362,14394,15565,270800,53153,57477,4957,4422
파주시,2022-09,4037,16897,14533,274837,61480,52878,2503,-1032
파주시,2022-10,3540,14415,14453,278377,51782,51918,-2482,-80
파주시,2022-11,3502,11243,13674,281879,39885,48510,-3172,-779
파주시,2022-12,3201,9437,11143,285080,33102,39087,-1806,-2531
파주시,2023-01,4338,17103,13137,289418,59094,45391,7666,1994
파주시,2023-02,12285,15136,13045,301703,50168,43237,-1967,-92
파주시,2023-03,57418,51103,37378,359121,142300,104081,35967,24333
파주시,2023-04,9000,18663,26488,368121,50698,71954,-32440,-10890
파주시,2023-05,5683,20779,24164,373804,55587,64643,2116,-2324
파주시,2023-06,3107,16090,19138,376911,42689,50775,-4689,-5026
파주시,2023-07,3328,12992,14980,380239,34167,39396,-3098,-4158
파주시,2023-08,2977,15312,12979,383216,39956,33868,2320,-2001
파주시,2023-09,2800,11748,14158,386016,30433,36677,-3564,1179
파주시,2023-10,2702,12644,12978,388718,32527,33386,896,-1180
파주시,2023-11,2172,11744,11557,390890,30044,29565,-900,-1421
파주시,2023-12,2198,13032,11814,393088,33152,30054,1288,257
평택시,2019-01,0,0,0,0,0,0,0,0
평택시,2019-02,0,0,0,0,0,0,0,0
평택시,2019-03,0,0,0,0,0,0,0,0
평택시,2019-04,0,0,0,0,0,0,0,0
평택시,2019-05,3145,820,252,3145,260731,80127,820,252
평택시,2019-06,467,111,356,3612,30730,98560,-709,104
평택시,2019-07,1789,1115,482,5401,206443,89242,1004,126
평택시,2019-08,231,49,502,5632,8700,89133,-1066,20
평택시,2019-09,71,10,187,5703,1753,32789,-39,-315
평택시,2019-10,1465,1181,436,7168,164760,60825,1171,249
평택시,2019-11,192,45,535,7360,6114,72690,-1136,99
평택시,2019-12,1351,1193,627,8711,136953,71977,1148,92
평택시,2020-01,256,59,502,8967,6579,55983,-1134,-125
평택시,2020-02,67,23,203,9034,2545,22470,-36,-299
평택시,2020-03,55,18,130,9089,1980,14303,-5,-73
평택시,2020-04,1966,1419,577,11055,128358,52193,1401,447
평택시,2020-05,24071,2389,1768,35126,68012,50333,970,1191
평택시,2020-06,6075,2048,1834,41201,49707,44513,-341,66
평택시,2020-07,7901,4149,3150,49102,84497,64152,2101,1316
평택시,2020-08,3755,2734,2905,52857,51724,54959,-1415,-245
평택시,2020-09,13822,6133,4846,66679,91977,72676,3399,1941
평택시,2020-10,6037,6098,5954,72716,83860,81880,-35,1108
평택시,2020-11,5756,7080,6311,78472,90223,80423,982,357
평택시,2020-12,8414,8673,7472,86886,99820,85997,1593,1161
평택시,2021-01,9449,6897,7283,96335,71593,75600,-1776,-189
평택시,2021-02,17949,7538,6025,114284,65958,52719,641,-1258
평택시,2021-03,9599,7538,6025,123883,60847,48634,0,0
평택시,2021-04,14014,12591,11081,137897,91307,80357,5053,5056
평택시,2021-05,6686,13681,12335,144583,94623,85314,1090,1254
평택시,2021-06,28441,21028,17953,173024,121532,103760,7347,5618
평택시,2021-07,6849,16583,17457,179873,92192,97051,-4445,-496
평택시,2021-08,6031,16583,17457,185904,89201,93903,0,0
평택시,2021-09,13317,16583,17457,199221,83239,87626,0,0
평택시,2021-10,13566,10059,10537,212787,47272,49519,-6524,-6920
평택시,2021-11,15500,16707,12470,228287,73184,54624,6648,1933
평택시,2021-12,6576,9875,12397,234863,42045,52783,-6832,-73
평택시,2022-01,4054,9764,10903,238917,40867,45635,-111,-1494
평택시,2022-02,3531,9033,9197,242448,37257,37933,-731,-1706
평택시,2022-03,2640,10982,10757,245088,44808,43890,1949,1560
평택시,2022-04,3532,11765,11404,248620,47321,45869,783,647
평택시,2022-05,2892,14315,11451,251512,56915,45528,2550,47
평택시,2022-06,4688,11683,13269,256200,45601,51791,-2632,1818
평택시,2022-07,4351,21636,19672,260551,83039,75501,9953,6403
평택시,2022-08,7054,14977,14305,267605,55966,53455,-6659,-5367
평택시,2022-09,6259,17005,15943,273864,62092,58215,2028,1638
평택시,2022-10,6518,19950,18225,280382,71152,65000,2945,2282
평택시,2022-11,5067,16103,17519,285449,56412,61373,-3847,-706
평택시,2022-12,5889,21636,19672,291338,74264,67522,5533,2153
평택시,2023-01,4799,15485,15832,296137,52289,53461,-6151,-3840
평택시,2023-02,4355,16356,13678,300492,54430,45518,871,-2154
평택시,2023-03,29088,14472,15497,329580,43910,47020,-1884,1819
평택시,2023-04,43823,25998,26900,373403,69624,72040,11526,11403
평택시,2023-05,8229,17996,22458,381632,47155,58847,-8002,-4442
평택시,2023-06,3605,13461,16769,385237,34942,43529,-4535,-5689
평택시,2023-07,2492,12871,13916,387729,33195,35891,-590,-2853
평택시,2023-08,2535,11391,12530,390264,29187,32106,-1480,-1386
평택시,2023-09,3627,20494,16656,393891,52029,42285,9103,4126
평택시,2023-10,3253,15078,15983,397144,37966,40244,-5416,-673
평택시,2023-11,2442,14060,14993,399586,35186,37521,-1018,-990
평택시,2023-12,2634,18357,14681,402220,45639,36499,4297,-312
포천시,2019-01,0,0,0,0,0,0,0,0
포천시,2019-02,0,0,0,0,0,0,0,0
포천시,2019-03,0,0,0,0,0,0,0,0
포천시,2019-04,28,15,0,28,535714,0,15,0
포천시,2019-05,1007,277,86,1035,267632,83091,262,86
포천시,2019-06,248,89,133,1283,69368,103663,-188,47
포천시,2019-07,893,346,106,2176,159007,48713,257,-27
포천시,2019-08,247,46,220,2423,18984,90796,-300,114
포천시,2019-09,141,43,95,2564,16770,37051,-3,-125
포천시,2019-10,473,357,157,3037,117550,51695,314,62
포천시,2019-11,144,48,178,3181,15089,55957,-309,21
포천시,2019-12,982,472,243,4163,113379,58371,424,65
포천시,2020-01,492,148,243,4655,31793,52201,-324,0
포천시,2020-02,1219,402,222,5874,68437,37793,254,-21
포천시,2020-03,942,253,315,6816,37118,46214,-149,93
포천시,2020-04,22783,719,484,29599,24291,16351,466,169
포천시,2020-05,26241,1032,844,55840,18481,15114,313,360
포천시,2020-06,5012,1371,898,60852,22530,14757,339,54
포천시,2020-07,2907,954,1351,63759,14962,21189,-417,453
포천시,2020-08,1241,1234,1229,65000,18984,18907,280,-122
포천시,2020-09,1378,1980,1830,66378,29829,27569,746,601
포천시,2020-10,869,1795,1899,67247,26692,28239,-185,69
포천시,2020-11,985,1684,1573,68232,24680,23053,-111,-326
포천시,2020-12,2269,1754,1574,70501,24879,22325,70,1
포천시,2021-01,2145,1471,1517,72646,20248,20882,-283,-57
포천시,2021-02,8257,1493,945,80903,18454,11680,22,-572
포천시,2021-03,5712,1493,945,86615,17237,10910,0,0
포천시,2021-04,5540,2449,2220,92155,26574,24089,956,1275
포천시,2021-05,1559,2701,2523,93714,28821,26922,252,303
포천시,2021-06,2724,3140,3144,96438,32559,32601,439,621
포천시,2021-07,1188,2327,2613,97626,23835,26765,-813,-531
포천시,2021-08,1130,2327,2613,98756,23563,26459,0,0
포천시,2021-09,4713,2327,2613,103469,22489,25253,0,0
포천시,2021-10,2855,1770,1899,106324,16647,17860,-557,-714
포천시,2021-11,7630,4000,2434,113954,35101,21359,2230,535
포천시,2021-12,4284,2612,3477,118238,22091,29406,-1388,1043
포천시,2022-01,1763,2669,3768,120001,22241,31399,57,291
포천시,2022-02,2312,2346,2691,122313,19180,22000,-323,-1077
포천시,2022-03,771,3311,2864,123084,26900,23268,965,173
포천시,2022-04,765,3136,3195,123849,25321,25797,-175,331
포천시,2022-05,857,3166,3278,124706,25387,26285,30,83
포천시,2022-06,1608,8086,3702,126314,64015,29307,4920,424
포천시,2022-07,2000,3377,3561,128314,26318,27752,-4709,-141
포천시,2022-08,1388,5000,4558,129702,38549,35142,1623,997
포천시,2022-09,1049,2993,4504,130751,22890,34447,-2007,-54
포천시,2022-10,984,5061,3688,131735,38418,27995,2068,-816
포천시,2022-11,820,3068,4282,132555,23145,32303,-1993,594
포천시,2022-12,759,3377,3561,133314,25331,26711,309,-721
포천시,2023-01,976,2739,3018,134290,20396,22473,-638,-543
포천시,2023-02,1073,3094,2912,135363,22857,21512,355,-106
포천시,2023-03,876,2920,3273,136239,21432,24023,-174,361
포천시,2023-04,1044,3305,3123,137283,24074,22748,385,-150
포천시,2023-05,877,4489,2418,138160,32491,17501,1184,-705
포천시,2023-06,720,2150,2135,138880,15480,15372,-2339,-283
포천시,2023-07,621,2252,1980,139501,16143,14193,102,-155
포천시,2023-08,723,4172,1802,140224,29752,12850,1920,-178
포천시,2023-09,972,2832,1978,141196,20057,14008,-1340,176
포천시,2023-10,857,2761,2337,142053,19436,16451,-71,359
포천시,2023-11,781,2611,2322,142834,18279,16256,-150,-15
포천시,2023-12,765,5334,2330,143599,37145,16225,2723,8
하남시,2019-01,0,0,0,0,0,0,0,0
하남시,2019-02,0,0,0,0,0,0,0,0
하남시,2019-03,0,0,0,0,0,0,0,0
하남시,2019-04,68,13,1,68,191176,14705,13,1
하남시,2019-05,4291,2415,430,4359,554026,98646,2402,429
하남시,2019-06,3254,1759,1478,7613,231052,194141,-656,1048
하남시,2019-07,2085,1621,1872,9698,167147,193029,-138,394
하남시,2019-08,1036,924,1503,10734,86081,140022,-697,-369
하남시,2019-09,3161,2798,2010,13895,201367,144656,1874,507
하남시,2019-10,3334,3819,2596,17229,221661,150676,1021,586
하남시,2019-11,1208,1338,2414,18437,72571,130932,-2481,-182
하남시,2019-12,1186,1969,2230,19623,100341,113642,631,-184
하남시,2020-01,3054,3964,3047,22677,174802,134365,1995,817
하남시,2020-02,3240,4428,3175,25917,170853,122506,464,128
하남시,2020-03,7450,8309,4702,33367,249018,140917,3881,1527
하남시,2020-04,36195,6654,5686,69562,95655,81740,-1655,984
하남시,2020-05,13447,7519,6550,83009,90580,78907,865,864
하남시,2020-06,5434,12286,8112,88443,138914,91720,4767,1562
하남시,2020-07,5426,11668,10907,93869,124300,116193,-618,2795
하남시,2020-08,2815,7072,10085,96684,73145,104308,-4596,-822
하남시,2020-09,6101,13978,12461,102785,135992,121233,6906,2376
하남시,2020-10,3736,7841,11015,106521,73609,103406,-6137,-1446
하남시,2020-11,3461,8547,9778,109982,77712,88905,706,-1237
하남시,2020-12,3899,7453,8355,113881,65445,73366,-1094,-1423
하남시,2021-01,5036,16786,12087,118917,141157,101642,9333,3732
하남시,2021-02,8152,14783,10857,127069,116338,85441,-2003,-1230
하남시,2021-03,5811,14783,10857,132880,111250,81705,0,0
하남시,2021-04,5439,14045,14721,138319,101540,106427,-738,3864
하남시,2021-05,4153,11646,13880,142472,81742,97422,-2399,-841
하남시,2021-06,12799,12333,13706,155271,79428,88271,687,-174
하남시,2021-07,4135,10090,11165,159406,63297,70041,-2243,-2541
하남시,2021-08,3915,10090,11165,163321,61780,68362,0,0
하남시,2021-09,8006,10090,11165,171327,58893,65167,0,0
하남시,2021-10,7507,13164,14264,178834,73610,79761,3074,3099
하남시,2021-11,7218,23558,19040,186052,126620,102336,10394,4776
하남시,2021-12,4363,15399,20204,190415,80870,106105,-8159,1164
하남시,2022-01,4172,18781,20083,194587,96517,103208,3382,-121
하남시,2022-02,4045,21998,19230,198632,110747,96812,3217,-853
하남시,2022-03,3534,11195,17341,202166,55375,85776,-10803,-1889
하남시,2022-04,4312,22600,21020,206478,109454,101802,11405,3679
하남시,2022-05,3730,27086,24481,210208,128853,116460,4486,3461
하남시,2022-06,3611,16283,19528,213819,76153,91329,-10803,-4953
하남시,2022-07,5450,6725,11347,219269,30670,51749,-9558,-8181
하남시,2022-08,4536,13357,15198,223805,59681,67907,6632,3851
하남시,2022-09,3531,27537,20984,227336,121129,92303,14180,5786
하남시,2022-10,4246,24568,22506,231582,106087,97183,-2969,1522
하남시,2022-11,2824,15319,18956,234406,65352,80868,-9249,-3550
하남시,2022-12,2286,6725,11347,236692,28412,47939,-8594,-7609
하남시,2023-01,4396,14806,12889,241088,61413,53461,8081,1542
하남시,2023-02,2752,10200,19231,243840,41830,78867,-4606,6342
하남시,2023-03,2354,10882,11829,246194,44200,48047,682,-7402
하남시,2023-04,2359,10580,11139,248553,42566,44815,-302,-690
하남시,2023-05,1832,10844,11053,250385,43309,44144,264,-86
하남시,2023-06,1594,9574,10118,251979,37995,40154,-1270,-935
하남시,2023-07,2107,10231,9659,254086,40265,38014,657,-459
하남시,2023-08,2409,9442,8931,256495,36811,34819,-789,-728
하남시,2023-09,3388,12991,11833,259883,49987,45532,3549,2902
하남시,2023-10,2456,12682,11979,262339,48342,45662,-309,146
하남시,2023-11,1785,14647,13667,264124,55455,51744,1965,1688
하남시,2023-12,1664,14814,13838,265788,55736,52064,167,171
화성시,2019-01,0,0,0,0,0,0,0,0
화성시,2019-02,0,0,0,0,0,0,0,0
화성시,2019-03,0,0,0,0,0,0,0,0
화성시,2019-04,4826,1476,204,4826,305843,42271,1476,204
화성시,2019-05,10661,4449,1392,15487,287273,89881,2973,1188
화성시,2019-06,4067,1224,2110,19554,62595,107906,-3225,718
화성시,2019-07,5995,3966,2868,25549,155231,112254,2742,758
화성시,2019-08,4019,2986,3157,29568,100987,106770,-980,289
화성시,2019-09,4032,4333,3048,33600,128958,90714,1347,-109
화성시,2019-10,3977,3227,3274,37577,85876,87127,-1106,226
화성시,2019-11,2312,2196,3284,39889,55052,82328,-1031,10
화성시,2019-12,3461,3634,3154,43350,83829,72756,1438,-130
화성시,2020-01,5321,5430,4142,48671,111565,85102,1796,988
화성시,2020-02,5985,5105,4422,54656,93402,80906,-325,280
화성시,2020-03,16286,5668,5210,70942,79896,73440,563,788
화성시,2020-04,279776,56389,25435,350718,160781,72522,50721,20225
화성시,2020-05,44065,16092,24029,394783,40761,60866,-40297,-1406
화성시,2020-06,7321,22661,25500,402104,56356,63416,6569,1471
화성시,2020-07,12653,24704,29835,414757,59562,71933,2043,4335
화성시,2020-08,5147,23911,25833,419904,56943,61521,-793,-4002
화성시,2020-09,11966,34415,31935,431870,79688,73945,10504,6102
화성시,2020-10,7078,30489,32642,438948,69459,74364,-3926,707
화성시,2020-11,7836,32921,30837,446784,73684,69019,2432,-1805
화성시,2020-12,7830,34410,30464,454614,75690,67010,1489,-373
화성시,2021-01,12936,32845,31312,467550,70249,66970,-1565,848
화성시,2021-02,23305,18016,20192,490855,36703,41136,-14829,-11120
화성시,2021-03,13378,18016,20192,504233,35729,40044,0,0
화성시,2021-04,23662,27897,27898,527895,52845,52847,9881,7706
화성시,2021-05,7615,26955,27578,535510,50335,51498,-942,-320
화성시,2021-06,19051,38556,36664,554561,69525,66113,11601,9086
화성시,2021-07,7297,21854,25453,561858,38895,45301,-16702,-11211
화성시,2021-08,6868,21854,25453,568726,38426,44754,0,0
화성시,2021-09,15106,21854,25453,583832,37432,43596,0,0
화성시,2021-10,15220,20030,18683,599052,33436,31187,-1824,-6770
화성시,2021-11,14975,46982,32149,614027,76514,52357,26952,13466
화성시,2021-12,8552,42716,38923,622579,68611,62518,-4266,6774
화성시,2022-01,6453,28712,36845,629032,45644,58574,-14004,-2078
화성시,2022-02,6309,28636,30433,635341,45071,47900,-76,-6412
화성시,2022-03,5886,32470,34372,641227,50637,53603,3834,3939
화성시,2022-04,5990,33664,33892,647217,52013,52365,1194,-480
화성시,2022-05,5738,32093,33836,652955,49150,51819,-1571,-56
화성시,2022-06,5429,34990,31881,658384,53145,48423,2897,-1955
화성시,2022-07,5499,44546,37550,663883,67099,56561,9556,5669
화성시,2022-08,5261,24110,28903,669144,36031,43193,-20436,-8647
화성시,2022-09,5000,44803,35060,674144,66459,52006,20693,6157
화성시,2022-10,6447,40644,36969,680591,59718,54318,-4159,1909
화성시,2022-11,6159,38054,35992,686750,55411,52409,-2590,-977
화성시,2022-12,5952,44546,37550,692702,64307,54208,6492,1558
화성시,2023-01,7038,29534,35112,699740,42207,50178,-15012,-2438
화성시,2023-02,7829,30162,33325,707569,42627,47097,628,-1787
화성시,2023-03,9111,35906,36982,716680,50100,51601,5744,3657
화성시,2023-04,8440,35557,35525,725120,49036,48991,-349,-1457
화성시,2023-05,6717,35058,37413,731837,47904,51122,-499,1888
화성시,2023-06,7821,36797,36269,739658,49748,49034,1739,-1144
화성시,2023-07,8026,36869,36480,747684,49310,48790,72,211
화성시,2023-08,7804,34116,35008,755488,45157,46338,-2753,-1472
화성시,2023-09,7792,40559,36188,763280,53137,47411,6443,1180
화성시,2023-10,7667,37117,38199,770947,48144,49548,-3442,2011
화성시,2023-11,6808,34953,32898,777755,44940,42298,-2164,-5301
화성시,2023-12,5854,17891,24971,783609,22831,31866,-17062,-7927
